1762年	年
任建新	秘书长
麦迪娜	演员
陈景磐	人
伊藤实华	配音员
戴君竹	演员
金月	语言学家
佟攀梅	人
李根	运动员
尹何	人
陈纳德	获得者
张晓强	人
管平潮	小说家
索元礼	人
冯端	人
林钦华	华人
魏光焘	按察使
何亚男	人
姚嘉文	人物
潘立刚	部长
金建华	委员
王秉彝	举人
李中襄	宁波人
郑文孚	人物
王占	昌黎人
张际亮	人
梁思成	受难者
杨正午	省长
李隽青	李家
陈金海	华人
徐立清	金寨人
魏子卿	科学家
周文静	画家
李朝威	作家
李渐荣	成员
林健锋	成员
刘长纯	人
荣泉	议员
1098年	年
杨如轩	人
陈良彪	人
施金典	球员
徐善	嘉兴人
判别式	行列式
林海峰	获得者
冯懋	人
郑名佐	人
刘毅	官员
颜思齐	龙海人
林右	人
吴由姬	人物
甘菁菁	经理人
张义纯	成员
唐德超	球员
简蕙芝	人
皮特凯恩群岛	群岛
盛宣怀	人物
臧振华	考古学家
于芷山	人物
李秉仁	人
阿信	电影
邓铿	人
魏乐唐	华人
川崎卓吉	议员
阳蕾	人
蔡毅	委员
许其亮	参谋长
李始	人
朱铁志	作家
赵安	人物
肖莺子	党员
菩提树	行道树
范必英	举人
江华	委员
詹体仁	人
俞敏洪	无锡人
张弥曼	人
赵式芝	同性恋者
汪师韩	诗人
李让夷	使
金振吉	党员
蔡来兴	商人
狗蚤	跳蚤
李正帆	作曲家
罗一民	官员
张辉	人
黄润达	议员
陈其昌	高安人
叶忒罗	人物
林家庆	制作人
奚啸伯	盟员
卫聚贤	人
庞祥麟	主持人
1304年	年
安肃军	军
晋惠帝	人物
褚圣麟	盟员
罗富昌	商人
赵姬	人
柳熙烈	主持人
方春明	市长
高殿民	记者
俞廉三	人
陈裕璋	董事长
范植谷	局长
金邦平	企业家
罗春梅	人
刘伟	市长
刘洪	天文学家
故宫	故宫
球阀	阀
吴乃琛	议员
石恶	人物
黄志华	音乐家
宋景	使
陈序经	思想家
三角镇	行政区划
劳干	人
王长寿	委员
马友友	校友
453年	年
商震	人物
何映华	副司令员
王华怡	人
干邑区	行政区划
陶柳	人物
年维泗	运动员
张知本	党员
柏景伟	举人
叶傲冬	议员
钱勇杰	宁波人
龚镇洲	会员
澳门基金会	基金会
陈履安	院长
张建邦	部长
朱洗	胚胎学家
郭振玺	人
松山州	行政区划
孙长卿	人
北斗镇	行政区划
郁国祥	商人
李婷	演员
施州	行政区划
马恒昌	人
李珉廷	演员
高世元	演员
张琮	官员
萧普达	人物
雷洁琼	副委员长
福泽谕吉	人物
邓钟岳	家
冯从龙	人
张君劢	人
韩寓群	副省长
沙文汉	省长
颜楷	人物
洪小文	人
李思捷	主持人
陈乃荣	作曲家
蒙进喜	四川人
1839年	年
赵申乔	使
阚维雍	人物
蒙文通	历史学家
袁华	运动员
马新岚	人
张菲	人
石景山体育场	足球场
梁锦祥	主持人
史青	人
大致坡镇	行政区划
崔铣	理学家
王田海	检察长
甘学阔	人
张泽	举人
白干	人
林辉	工作者
吴敦义	市长
卓惟休	人物
常世国	地方
马步芳	党员
毛文锡	官员
钱允治	藏书家
高孝珩	官员
韩凤林	人物
吴昆玉	党员
温璜	人物
李杨	主持人
望月信雅	人物
郑水枝	党员
冯建国	球员
胡家燕	委员
柯远芬	县长
石延年	人物
郭隆真	人
王小庄	大使
贺诚	委员
戴娆	演员
范立础	人
林衡道	党员
张德广	秘书长
梁海明	委员
韩德	人物
麦嘉	华人
徐圣禅	党员
徐荣	举人
邹瑜	局长
冈崎律子	人物
李进勇	首长
严从简	作家
黎辅陈	官员
姚健	守门员
李斌	官员
李金泉	音乐家
白修德	小说家
二界沟镇	行政区划
常万全	南阳人
谢静宜	人
印侯	人
胡霖	记者
吴武雄	宜兰人
安邑县	行政区划
陈伟文	人
王克英	厅长
嘉义市	行政区划
马牧鸣	大使
李祥	人
贝塔斯曼	公司
程红	官员
许宝蘅	杭州人
寇绍恩	台湾人
王占国	人
十月革命	革命
朱曼子	播音员
1954年	年
张龙翔	人
刘溥	大使
管中祥	作家
古雷兽	雷兽
阳春市	市
韩雍	苏州人
李宗津	画家
中国人民抗日战争纪念馆	博物馆
刘克庄	人
王子涵	演员
1393年	年
格林纳达	国家
麦飞霏	主持人
鸡皮疙瘩	出版物
杉山爱	人物
陈自瑶	演员
王若麟	演员
吉川广家	人物
区适子	人
唐守道	人
曹光琳	副部长
木林镇	行政区划
朱右曾	历史学家
林兰英	委员
苏荣	官员
宋丰强	委员
王景荣	秘书长
元长仁	人物
冯绍波	工作者
李保民	企业家
李应敬	演员
1368年	年
中国人民银行	机关
暴风雨	画作
颜清标	成员
丰卷	人
赵丽华	作家
吴玉谦	人
宋雨桂	委员
田期玉	副部长
刘郁芬	人
陈之龙	使
范伟	演员
谭兆伟	球员
詹雅菁	人
江彰吉	校长
壬酸	羧酸
易思玲	运动员
袁国强	委员
毛泽东	人
斋食	饮食
金泽	南京人
林明子	人物
胡永柱	委员
黄继俊	企业家
王莽	人物
汪东	理论家
陈远美	人
刘粤军	司令员
安雅	演员
巩州	行政区划
周林	副部长
木棠镇	乡镇
谢东荣	人
江毅	艺员
朴海美	人物
韩炳宸	人物
高福荣	球员
刘小萌	历史学家
泽州	州
潘鼎新	人
林番王	人
夏振贵	人
徐志摩	嘉兴人
邓紫飞	四川人
刘志峰	副部长
杨志烈	使
何容	编纂者
周谷城	委员
阮鹗	人
老友记	节目
徐晨	运动员
苏慧廉	英国人
940年	年
肇俊哲	人
武艺	演员
蔡奇	部长
乔石	委员长
殷淳	人物
张盛舒	台湾人
马士杰	议员
龙润茶	公司
孟德尔	遗传学家
王岗	演员
章如愚	人物
马千龄	人物
橘梨纱	人物
于海	球员
谢尚	家
牛萌萌	演员
李大卫	人物
秦基伟	部长
西汉	政权
张超雄	人
香港高等法院	法院
张榕明	领导人
慧皎	人
悉尼奥林匹克公园	公园
宋教仁	会员
王以路	演员
兴宁市	市
殷凤梧	人
张桂华	人
李永达	人
朱发忠	委员
马全	人
侯瀚如	评论家
渡边麻友	成员
黎铮	诗人
赵延寿	官员
杨玉欣	人
天知茂	人物
谢旭人	局长
宣信	人
毛齐华	委员
金美龄	党员
任雁	哈尔滨人
1320年	年
江静	委员
李贞淑	人
祖师庙	庙宇
崔忠献	人物
胡婷婷	演员
陈景润	数学家
潘珍	人
蔡式渊	人
吴喜	人物
金起范	艺人
王益霖	教育家
安铁成	企业家
河南师范大学	大学
闵春晓	南昌人
1161年	年
徐彬如	委员
李明贤	记者
陈其五	受难者
郑石岩	作家
宗怀德	人
张艾嘉	人
秦仲达	部长
王西欣	副司令员
城市	地
蔡袁强	人
王修智	市长
冯景禧	人
李儒	人
舒巷城	作家
张耕	唐河人
陈信宏	作曲家
刘湘	人物
李幼贞	演员
宏九印	大使
蒋伊	举人
李泰林	演员
怀思公主	公主
牛魔王	牛
应松年	宁波人
凌福彭	人
张抗抗	作家
茅祖权	秘书长
李荫	人
晋松	演员
1861年	年
王涉	人物
寇遐	总长
盖山镇	乡镇
陶澍	无锡人
李建华	人
方保罗	演员
苏兆登	使
赵啸天	运动员
唐献陵	陵
界牌镇	行政区划
王伟康	运动员
袁昶	使
周成虎	地理学家
阿瓦库姆	家
洪浩	人
许晨晔	人物
佐藤哲夫	运动员
刘邦	人
刘备	河北人
韦世康	人
田诚阳	人物
李起鹏	人物
何祥友	队长
黄正利	演员
公立学校	学校
聂海胜	飞行员
开封市	地级市
高忠信	党员
项圣谟	嘉兴人
潞城市	城市
袁弥明	人物
张洛君	演员
曲格平	人
临海市	市
曹志杰	球员
陈云涛	委员
李世济	党员
蓝夜	福建人
刘晓	委员
郭隆真	党员
世兴	人
代蒙	生物
贝伦	人物
郑雁雄	汕头人
史熙	演员
黄昭堂	历史学家
阮文平	人物
谢海盟	同性恋者
董正浩	党员
石玉珍	委员
巴奇	队长
蒋洁敏	委员
曹添堡	球员
沈寿民	人物
武德	人物
王正	运动员
马诚	人
聂真	委员
林述庆	人物
叶山武	作曲家
黎辅陈	人
格寿平	法国人
吴文度	使
姬觉弥	徐州人
文年生	人
王任叔	理论家
高明区	辖区
李纯恩	主持人
顺德县	行政区划
赵守博	党员
高孔廉	党员
沈宗瀚	党员
东周国	国家
朱静芝	领导人
周兴铭	余姚人
撒哈拉沙漠	沙漠
廖均健	运动员
1656年	年
刘新成	会员
丁取忠	人
金硕仁	市长
黄应贵	人
刘泽熙	人
刘德利	人
朱徽	人
季胜	东夷人
孟宪来	人
臧式毅	人物
东营市	城市
吴香伦	艺员
余心清	人员
仲里依纱	艺人
叶如棠	委员
王子祥	司令员
高家镇	行政区划
竺法雅	僧人
绿珠	人
王伯群	会员
陶璜	人物
陈锡联	省长
王子颓	人物
毛岸青	儿子
扁鹊	人
蔡育瑜	运动员
李德全	成员
盛唐郡	郡
杨元元	人物
黄如楷	委员
罗名士	人
杨雪兰	华人
大喜	演员
周天华	运动员
乌鲁木齐站	车站
苏士亮	参谋长
陈荣凯	官员
陈家鼎	议员
阎红	运动员
伊藤博文	议长
叶璇	杭州人
黄克立	福建人
何厚铧	人物
横店镇	乡镇
中国人民解放军海军	海军
铃木绘理	人物
赵丽宏	委员
陈修信	华人
1897年	年
陈荣捷	人
巴塔哥尼亚	公司
林蕙	主持人
陆奇	人物
陈于泰	宜兴人
李琳	人物
吴国雄	气象学家
路建人	守门员
许冠英	人
刘格平	官员
氯化亚砜	亚砜
武攀凤	南京人
晚间新闻	新闻
曹元弼	苏州人
金承奎	守门员
牛兰	犹太人
490年	年
尤加奈	配音员
希腊	领土
高建民	人
陈裕南	成员
巴音朝鲁	委员
人物	出版物
宣铁吾	人物
萧煌奇	制作人
程介南	人
曾国荃	人物
柳智宇	人
吴俊升	人
乌尔衮	人物
童渊铭	人
郑继伟	副省长
张泉灵	记者
崇福镇	行政区划
顾坚	剧作家
黄允财	主持人
孟庆平	官员
林振国	部长
张正男	党员
颜之仪	临沂人
林鹤年	作曲家
数理经济学	经济学
马晓伟	人
鄂维南	人
高岗	人物
钟晓渝	委员
严信厚	人
尹奉吉	人物
林家庆	获得者
苏联部长会议	机关
刘小丽	评论员
西螺镇	地名
张光翰	人
张锡铭	成员
宗才怡	企业家
李元礼	人物
隋州	行政区划
伍光建	家
李春江	人
田文仲	演员
黄贵裕	球员
通法寺	佛寺
王怀远	市长
王冠	人
罗孝全	人
六月	主持人
胡熙明	人
竹冈美穗	画家
十八般兵器	武器
高永	人
南广郡	行政区划
黄封	人
励廷仪	举人
帕耶讷	市镇
邱茂男	客家人
弘始	年号
陶谐	人
陈宝玲	主持人
胡国雄	球员
徐才厚	政治委员
白凤鸣	音乐家
孙基祯	获得者
白健恩	演员
王宠	画家
牛红光	人
黄晴宜	部长
星野源	作曲家
杨荫浏	音乐家
许绶泰	生物学家
罗方	人
李蒙	委员
石油化学	化学
丁霞	运动员
秦刚	司长
武延基	人物
邵逸夫	商人
1223年	年
杨昊	球员
49年	年
李纨	人物
楼缓	人物
马良弼	人物
江文	部长
王始	人物
李研山	人
侯玉琢	运动员
李寿全	制作人
谢文德	配音员
邱万城	演员
塘沽区	区
薛香川	委员
张捷	演员
谢韶光	客家人
真庆观	道观
陈丕显	人
陈度	人
董时进	人
刘邺	诗人
裴优	人
盛昱	历史学家
彭德忠	人
杨维哲	党员
李荫远	人
华为	公司
陈文刚	演员
李崇萍	宜兰人
胡春宏	水利学家
庄乐峰	人
郑龙珠	舞者
毛妹	舞蹈家
脱脱	官员
八通关	地名
郑家纯	委员
干诺道	干道
王震生	人
杨永明	主持人
萧新煌	民族学家
许其亮	委员
田丽	获得者
外文出版社	出版社
刘宇昆	作家
李明俊	球员
郭添财	人物
符宁	柬埔寨人
武陵农场	农场
守车	货车
金士杰	台湾人
程子华	人
沈士贤	人
西村雄一	人物
罗福星	者
渡濑悠宇	人物
石嘴山站	车站
高道先	牺牲者
大顺国	政权
孙建国	厅长
李勇	副部长
刘彝	人
榆垡镇	行政区划
扇千景	议长
郑爱利	人物
陈翔	演员
王昌	会员
周保中	获得者
邓正来	家
杨惠姗	演员
同安郡	郡
袁淑珍	配音员
苏秋镇	委员
李天宠	人
挪威语	屈折语
徐沛	者
杨钊	成员
莫乃光	商人
郭凤莲	企业家
朱武献	局长
桓焉	人
徐青甫	党员
沈星	演员
郭志贤	演员
笑林	演员
李芸	人物
马彦平	县长
贾晓晨	艺员
结城藩	藩
丁衡高	委员
袁霆	演员
李国鼎	委员
郑遵谦	余姚人
风动石	岩石
东尼	英国人
郭德洁	人
梁伟发	县长
范朴斋	会员
徽州	州
周厚复	人
周赤萍	人物
王林	副部长
阮肇昌	市长
侯渊	人
加蓬	国家
符润光	音乐家
1855年	年
吴化文	委员
胡宿	人
夏元瑜	杭州人
郑石岩	宜兰人
李浩修	哈尔滨人
李中	人
大仲马	小说家
黄昌谷	教育家
王泰生	余姚人
成肇毅	杭州人
常遇春	人物
美敦力	公司
691年	年
越狱	节目
罗应荣	历史学家
滕代远	委员
赵庄姬	人物
黎文卓	作家
斋堂镇	乡镇
西野朗	人物
张桃林	人
欧胡岛	火山岛
李小双	人物
张家辉	华人
加勒比海	陆缘海
詹奎	人
刘新成	人
李叔明	人物
李罗权	人
王清峰	台南人
张美远	长
张莉	演员
救援	演员
鄂州市	地级市
邱议莹	客家人
杨玉珍	商人
王侄	人物
屈伸	人
陈思	人
袁同礼	华人
老子	道家
赵家蓉	人
宇文洛生	人物
李至刚	人
谈维煦	人
金武烈	演员
张根生	人
西沙群岛	诸岛
何耀珊	华人
朱延祥	人
石俊	党员
张元奇	人
巴生市	城市
臧克家	诗人
叶恭绰	人
傅铁山	逝世者
陈立夫	董事长
曹策问	人
林政则	议员
李丽连	议员
姜伟新	学员
张家界市	城市
洪丕谟	家
王博	人
郑林	副省长
管平湖	研究员
卜大同	嘉兴人
最优控制	控制
张清源	委员
罗丽莎	艺员
长野市	城市
刘信	官员
顾宪成	举人
程树德	法学家
雷洁琼	教育家
房喻	校长
杨多良	人
周德荣	人
艾成	华人
张晓兰	人
欧阳格	党员
薛凌	党员
符浩	副部长
萧图玉	官员
宗泽亚	华人
石秀诗	人
湘西土家族苗族自治州	行政区划
阿席熙	人
刘文俊	演员
Ƒ	字母
韩义生	艺员
简乃杰	官员
龙冠海	社会学家
欧阳文风	人物
钱树芬	人物
阮氏路	人
陈国祥	议员
统计力学	力学
萧家淇	党员
罗恕人	台湾人
祁充格	人
陆世仪	理学家
杨凝式	人物
张雨	苏州人
杨元丁	人物
李书茂	副司令员
后赵	国家
龙天生	配音员
郭德刚	成员
丁茵	演员
克莱儿	人
雷于蓝	市长
张选青	教育家
尹伊桑	人
陈可辛	人
王庆祥	演员
李沧东	人物
王志均	生理学家
多瑞亚	球员
王勋	台湾人
黄遵宪	人
陈丹淮	儿子
张家莹	艺员
吴贯因	语言学家
陈家琪	人
水郡线	路线
王璧	人
谭玉兰	演员
乌青	作家
胡建学	人物
丁乃扬	人物
李玮锋	人
徐国权	委员
海秀镇	行政区划
文熙俊	演员
赵汝适	人物
董燕生	出生
张元龙	委员
傅作义	党员
芝加哥大学	大学
江春男	作家
罗曼死	歌曲
谭恩德	运动员
Ę	字母
吕荣寰	人物
埃桑	市镇
李蔚然	人
宋晓云	运动员
周叶中	法学家
骆养性	人
韩固	人
庆熙大学	大学
陈介	杭州人
崔宇植	人物
金性洙	人物
徐运北	部长
德安公主	公主
王洛勇	艺人
李井泉	省长
1755年	年
黄世惠	人
林国芳	商人
劳政武	人
梁雪湄	商人
徐乐	人物
郑晨	运动员
萨孟武	台湾人
王谟	人物
李宣倜	剧作家
救世主	称号
魏国强	人
王贺	人
罗光	台湾人
夏靖庭	台湾人
1908年	年
邓颖超	参政员
叶嘉莹	华人
秦出公	人物
万国鼎	历史学家
魏秋月	运动员
叶伟明	成员
王隐林	武术家
黄光男	校长
暗物质	问题
弹子锁	锁
王国宝	人物
胡蝶	人
王鲁明	大使
井上笃夫	家
张迅伟	球员
梁田	人
程国胜	人物
马景涛	演员
杨玉如	人物
李同国	球员
敦煌石窟	石窟
三一学院	机构
马湘君	运动员
黄荣辉	气象学家
金贺恩	人物
胡海岩	科学家
金人庆	苏州人
赵敦临	学者
1743年	年
靳尚谊	院长
董成鹏	吉林人
杜俊元	企业家
孙端镇	行政区划
延平王	郡王
邰丽华	宜昌人
张北县	县
王怀忠	市长
君临天下	建筑物
郭伯雄	人
潘玉良	画家
楚图南	党员
胡焕庸	无锡人
贝娅特丽克丝	幸存者
大野耐一	人
张宏年	议员
阎洪臣	党员
章必功	评论家
谢小军	委员
袁时中	人
高原直泰	人物
刘半农	家
袁守芳	人
陈演生	出生
生母	声母
黄志遴	人
德令哈市	市
王贵德	委员
胡建伟	人
涂坊镇	行政区划
刘德凯	演员
荀悦	经学家
吴岩	作家
温大雅	作家
李之椿	人物
土地庙	庙宇
杨婉仪	参赛者
梁碧玉	演员
伯利恒	地名
曹颖	主持人
王玉川	人
732年	年
储大文	诗人
翁玉耀	市长
陈吉宁	委员
卢士燕	人物
邓本元	市长
涂黎曼	演员
沈福宗	人物
吴椿	诗人
李跃龙	人
太平洋百货	机构
林俊义	党员
胡金铨	演员
万宁县	县
应蔚民	台湾人
李先闻	台湾人
王大任	人
许倩芸	作家
任世茂	市长
李元阳	作家
骆成骧	举人
468年	年
孟安明	委员
郝水	人
吕思清	音乐家
常枫	获得者
陈希愈	人
陈硕茂	人
朴载正	人物
隋俊波	演员
徐开垒	宁波人
陆宝荪	人物
耶斯迦	语言学家
杨思恭	人物
赖若愚	委员
陈幼学	无锡人
黄一凤	人
张勋杰	演员
邓子恢	领导人
翁彦约	人
田邑	人物
杜联	人
伍蠡甫	人
范数	代数
北京工人体育场	足球场
罗百吉	家
张秀龙	司令员
小汤山镇	行政区划
三元桥	桥梁
杨碧川	人
叶春	人
合浦县	县
白云	部长
周勇军	人
915年	年
林干	人
林保淳	作家
梅溪镇	行政区划
何基佑	主持人
大连市	市
网际协议	协议
梁滨	官员
陈志清	主任委员
杜正胜	院长
黄伊汶	商人
华歌尔	公司
1410年	年
孙鹤皋	藏书家
南威尔斯	威尔斯
陈金声	人
郭文贵	企业家
庞涓	人物
吴泽刚	人
贾雨岚	演员
金青	人物
周滨	企业家
东清彦	漫画家
郑裕彤	家
铁锋区	辖区
夏仁虎	诗人
普莱西	人
郭泰源	台南人
野岛伸司	诗人
郑成美	华人
藤原纪香	人物
651年	年
林庆台	演员
杨璧	人
岳州路	行政区划
萧启庆	历史学家
危朝安	副部长
张勋	省长
彭林	运动员
应松年	法学家
罗塔	市镇
申公豹	人物
姚龙	使
袁翼	企业家
瑞士	国家
张迈曾	人
薛侃	人
马希杲	官员
蔡炳炎	人
张謇	举人
赵匡凝	使
梁夫人	夫人
封柔	官员
凌义渠	人
方东美	大家
汇川区	辖区
萧赞育	台湾人
袁似道	人
刘慧晏	人
刘政会	人物
汤化龙	总长
何家成	官员
田中一成	人物
张志刚	秘书长
柯清辉	人物
解缙	吉水人
郑祖	演员
廊坊市	城市
刘英俊	人
王志民	人
章明	副部长
袁彩云	参赛者
邱泽	演员
何应钦	会长
钱江	人
高佑丽	舞者
何祥友	球员
陈德	人
徐柏园	参政员
张渊微	人
朱昌颐	人
中国邮政	企业
洪炜	人
陈振雄	人
茹法亮	官员
莱阳县	行政区划
香鱼	食用鱼
1690年	年
吴宪	遗传学家
廖鲁言	委员
网络管理员	专家
郭宗熙	人物
赵仕北	人
高玉葆	校长
郭秀仪	人物
汪润之	杭州人
国家烟草专卖局	国家局
陈傅良	经学家
赵丕廉	人
温大雅	人
李明宪	艺员
刘正威	委员
71年	年
毛梦漪	宁波人
邓小刚	人物
王玉芝	委员
王宇	演员
李全教	党员
陈安众	官员
远征	人
韩璞	人物
反意	情绪
鲁园	演员
宁西军	军
1259年	年
波利伯孔	人物
王昶雄	小说家
程天放	教育家
黄永昌	人
丁芒	诗人
罗振江	人
李黎	作家
王明方	部长
简太郎	秘书长
党家庄镇	乡镇
兖州煤业	公司
僧伽罗语	屈折语
格吕耶尔	市镇
黑色素	色素
英英	演员
基诺族	民族
张子岱	球员
谢升	人物
孔雀	演员
勉县	县
谭继洵	人
苏永钦	党员
赖幸媛	委员
袁鸣	主持人
刘钊	人
李杨	演员
吴光正	委员
石岛	永兴岛
王周	人物
杨松	厅长
何美钿	演员
卡考	人
黎塞留	人物
王中军	企业家
陈敏	人
萨孟武	政治学家
薛中锐	人
陈毅	人物
周诒春	部长
陈千武	小说家
李范永	人物
易班	网站
陆贾	人物
杨石	官员
吴畹卿	音乐家
黄彰辉	参与者
郑俊英	演员
张淮深	人
李会昌	人物
封孝琰	人物
李健熙	获得者
筱俊亭	委员
王艳娜	演员
童菲	人
王隽	杭州人
北村薰	人
梁岩峰	球员
马坚	语言学家
李广田	自杀者
倪润峰	企业家
李政颖	演员
酱菜	蔬菜
田州塔	塔
金孝珍	人物
卢嘉辰	市长
林思齐	企业家
杨福家	学者
龙超云	委员
邵帅	运动员
丙醇	醇
张琰	人
方季韦	人
叶毓山	雕塑家
叶炜	小说家
朱茵	人
倪良耀	使
恩雅	音乐家
塞尼斯托	外星人
兰茜	主持人
梅茂县	行政区划
古浪县	县
纪佳松	加拿大人
刘维维	委员
罗什	市镇
840年	年
杨日松	逝世者
李端	人
森进一	人物
小野友树	人物
泸州市	地级市
佐藤仁美	配音员
1441年	年
张际春	受难者
陶渊明	人
咸镜南道	行政区划
刘海粟	教育家
金艺玲	演员
屠勋	人
占陇镇	建制镇
梁梦龙	人
梁耀枢	举人
杨起元	人
马鲛鱼	食用鱼
周南	副部长
郑兆强	获得者
李在奎	人物
西西	教育家
王宜林	委员
夏龙	逝世者
张国立	会员
王晨	运动员
张穹	法学家
周杰伦	得主
唐蒙	官员
社会民主党	成员
孝感市	地级市
黄靖伦	人
张国清	企业家
朱彩	人
金富轼	人物
褚亮	杭州人
陈国富	人
陈德荣	市长
周振东	大使
麦长青	演员
李勤勤	演员
黄春明	小说家
高仲密	人物
璩美凤	记者
吴健保	议员
马准	文学家
陈笙郊	家
俞飞鸿	演员
横滨市	城市
魏丽惠	党员
顾毓瑞	大使
铃木大辅	球员
市	行政区划
李捷	党员
专家系统	系统
杨证桦	人
胡汉民	举人
麦华三	家
温少鹤	委员
侯冠群	台湾人
王学军	委员
崔建邦	主持人
陈怡嘉	人
俞飞鹏	部长
广邑州	州
谢贤	艺员
龚鹏程	作家
系统文件	文件
876年	年
翁静晶	人
徐新荣	人
翁惹化	人
谢启中	会员
陈俊武	化学家
张培荣	人
王庆平	使
胥克	人
蔡琼辉	华人
汤显祖	人
王伟光	专家
第二国际	组织
张近东	企业家
古冶区	辖区
侯光炯	土壤学家
胡岳	人
张鸿南	慈善家
李志奇	人物
罗正富	彝族人
刘克宣	艺员
谭惠珠	人物
李梵	天文学家
溪州	行政区划
李欣芸	制作人
雷坪镇	行政区划
徐国元	市长
庞掌运	举人
德永英明	人物
同工同酬	人权
宋建成	人物
新桥镇	行政区划
江淹	作家
房兆楹	历史学家
郝平	演员
佟大为	人
刘建锋	人
张华	作家
苍井空	演员
罗广斌	自杀者
贾贤英	作曲家
太姜	人物
文素勤	湘乡人
侯冠群	人
庄大田	人
徐荣凯	人
林韦君	演员
顾俊	入选者
黄承彦	人
伯益	东夷人
刘熙载	学者
陈锦涛	议员
沈北海	官员
苏达	演员
马纪壮	党员
金洪	人
政治委员	官员
康有溥	官员
刘涌	死刑犯
南江镇	行政区划
焦桐	文学家
乌青	小说家
崔德祺	议员
温子	人物
郭大建	市长
短笛	武术家
刘玉嘉	记者
源城区	辖区
林励吾	化学家
杨宝玲	华人
于斌	校长
李小龙	人
胡慎之	企业家
王巡	官员
刘茂	人物
吴振芳	官员
李元	演员
蔡来兴	官员
曾巩	作家
戎文佐	经济学家
卢日新	人
夏格庄镇	行政区划
田浦环	配音员
任福黎	议员
耿全斌	人物
吴鸿宾	党员
季公鸟	人物
刘铸伯	议员
刘道	人
宫磊	球员
己内酰胺	内酰胺
陆心源	书家
张铁林	艺人
杨宝玲	人
农德孟	人
张峻宁	南京人
聂安达	演员
陈绍澧	化学家
石璧	举人
崔允英	人物
岳海岩	政治委员
赖晓谊	演员
北林区	辖区
阮大年	次长
张志坚	政治委员
杨斌	商人
韩祯祥	教育家
阿志	澳大利亚人
郑宝鸿	商人
黎念之	华人
李勤岸	参与者
马嘉族	民族
蒋作君	副部长
陈慧仪	主持人
隆禧	人
殷巧儿	艺员
邢贲思	杭州人
张杨杨	运动员
单平	人
陈树人	记者
薄熙来	省长
法兰卡	球员
马继龙	人
虞爱华	市长
刘凤起	举人
姬达	专员
南青山	青山
周伯阳	人物
杨昕	瑞安人
许根俊	委员
朱俊	运动员
李嘉龄	钢琴家
杨增炳	议员
曹毓瑛	江阴人
刘树芳	生物学家
林锡光	人物
金曜焕	人物
马福祥	人
谢邦定	大使
张兴世	人物
韦昌辉	人
陈俊麟	人物
木村昴	配音员
赖幸媛	官员
丁鹤年	人
谭惕吾	成员
慧威	人物
萧叔宣	人物
刘国中	秘书长
Ѳ	字母
龚全安	使
周堪赓	人物
史贻直	人
周俊伟	演员
李庆霖	人
羽田孜	人物
凌汉	演员
朴明洙	演员
潘罗支	人
刘锦	举人
渡边一夫	家
石峰	演员
林家亮	球员
陈昭荣	主持人
陈学冬	演员
氯丁橡胶	橡胶
永乐店镇	乡镇
苟芸慧	台湾人
夏侯威	人
魏骏杰	艺员
李文珊	委员
中国物理学会	学会
渝州	行政区划
滕元公	人
孔泉	人
毛宗岗	评论家
艾儒略	意大利人
张鸿南	客家人
罗兰	人
施玉麒	工作者
吴景鸿	会员
孙致弥	人
傅善祥	人物
刘莉	副省长
邱君强	指挥家
金宣儿	人物
元献皇后	皇后
郦道元	人
温少鹤	人
阮振铎	人物
梁成金	企业家
刘季洪	人
香界寺	佛寺
邓颖超	领导人
吕在模	厅长
飞跃	公司
吴秀明	人
荆政芳	人
陈泽宪	人
濮县	行政区划
姚萍	客家人
卢奥族	民族
王若伊	人
吞噬细胞	白细胞
毛昭晰	长
林二汶	人
诸重光	余姚人
Ҵ	字母
高思博	委员
李韫慧	人
佐藤秀方	人物
黎瑞刚	人物
雷加	人
郭侃峰	球员
陈光甫	委员
马耳他	政权
何浩若	人
社旗县	县
常惠	人物
刘克崮	委员
高桥尚成	球员
袁绩懋	人
艾原道	人
李永	党员
鲜于善	演员
王伦	人物
刘震寰	柳州人
奥地利	国家
严智泽	委员
孙春兰	领导人
吴三桂	人物
邓子恢	农学家
水谷隼	人物
舒新城	人
李彦宏	企业家
陈吉宁	人
刘绍臣	研究员
鸟人	鸟
藤井裕久	人物
王馨平	演员
朱继圣	天津人
宋硕	逝世者
波罗莫	人物
张同钰	副部长
李鹏飞	商人
刘思彤	演员
吴天君	市长
殷士儋	人
郭仲衡	人
林嘉华	艺员
杨建平	人
乔庄	演员
吴启迪	教育家
余中先	作家
孙嘉禾	人
生命	歌曲
冯世良	委员
章文琪	运动员
越南语	语言
赵季平	作曲家
送报员	人物
李庆霖	人物
张镛	人
沙坪坝区	辖区
方俭	活动家
熊赐履	学者
孙建国	委员
黄中原	家
袁正中	官员
贺军翔	演员
陈小春	人物
洪汝珍	演员
徐则臣	小说家
卢荣景	委员
北红村	行政区划
施闰章	诗人
云山镇	行政区划
张尧学	人物
王世泰	委员
龙安府	府
翁慧德	参赛者
赵兰田	政治委员
唐继尧	省长
李定	人物
阿拉伯国家联盟	组织
陈焕友	校友
姜贵	小说家
李星沅	按察使
巫启贤	客家人
蔡万才	委员
薛延忠	人
田北辰	人物
毛新宇	家
张伯谨	公使
毛福民	委员
黄仁宇	人物
罗约翰	翻译者
利库德集团	政党
黄桥战役	战役
徐诵明	病理学家
杨匡	人物
吕鹏	运动员
藤原芳秀	人物
邹铭	秘书长
陈伟文	作曲家
1354年	年
孙金龙	委员
耶律燕哥	官员
吴文雄	运动员
金黑	人
四元桥	立交桥
宁武	会员
刘志华	官员
王志成	副司令员
周建屏	人
谭平山	部长
戴嘉猷	人
郎廷佐	人
新西兰	纽西兰
苏杰	局长
岩崎宏美	获奖者
杨以德	使
李士桢	人
陈雍	副部长
张荫麟	历史学家
杨海坤	委员
保定路	行政区划
顾作霖	逝世者
岭北镇	行政区划
廖平	人
王世贞	历史学家
赵柯	演员
奥驰亚	公司
向楚	成员
胡玲	华人
陈进兴	获得者
蔡诗萍	台湾人
萧萧	作家
陈尔锡	家
杨琼璎	人物
包明德	委员
谢娜	演员
光禹	小说家
沈旭晖	学者
翁心梓	教育家
仲野裕	配音员
吴德	人
王俊棠	艺员
仁心仁术	节目
魏东	企业家
洪兴祖	人物
李际泰	部长
长渊刚	演员
梁思浩	艺员
范多富	人
刘鸿庥	委员
陈咏	余姚人
孟连傣族拉祜族佤族自治县	自治县
Ҭ	字母
蒋方良	夫人
项燕	人物
周磊	运动员
吴语	语言
后秦	政权
兰保	角色
蔡国威	艺员
黄玉郎	演员
龚芝怡	作曲家
魏钢	参谋长
西天尾镇	乡镇
南礼士路	道路
彭旦	人物
王谔	画家
徐时栋	历史学家
华江桥	公路桥
陈楚楠	华人
谢晖	运动员
杨烈	获奖者
黄新廷	人
弓裔	人物
陶淑菊	人物
山本音吉	人
陈玉梅	人
朱铉	演员
章培恒	人
海陵郡	行政区划
杨福昌	大使
汪勃	人物
黄佩蒂	运动员
卢沛宁	人物
奥图尔	校长
陈梦吉	顺德人
南冕座	星座
杜清	人
张宁	主持人
井上真央	主持人
子路	人
邗江区	市辖区
刘香萍	华人
李祖夔	人
张佳宁	吉林人
王绍徽	人
洪伯文	企业家
文江县	县
阎明复	人物
董秉纯	诗人
罗梅	党员
罗锦龙	球员
马鸿烈	委员
赵静仪	演员
刘志忠	人
鱼尾狮公园	公园
冯亦代	家
苏志威	主持人
毛剑卿	球员
崔亮	运动员
彭宾	人物
素性	人
李荷娜	人物
横山智佐	配音员
陈复生	艺员
金利通	公司
浏阳市	城市
杨志峰	盟员
郭子恒	委员
陈永棋	委员
柳宗元	家
孟飞	武术家
苏志佳	党员
黄宗羲	人物
施乃良	大使
贝岭	华人
葛香亭	获得者
郭建宏	制作人
王玉环	商人
唐良智	人
郭泰祺	部长
谢建辉	厅长
李师古	使
陈岚	电影人
邓力群	部长
广济寺	塔
程元振	人物
夏竦	人
杜旃	人
李录	人
杨燕怡	宁波人
邱毅	经济学家
马懿	人
赵成珉	人物
李永平	客家人
龚国泰	指挥家
1993年	年
吴双艺	宁波人
云中郡	郡
陈向群	副部长
洪宗玄	演员
郭金发	人
王卓钧	人物
黄春荣	运动员
诸葛尚	人物
钱唐郡	郡
武山县	县
殷鸿福	古生物学家
黄尊素	余姚人
张涵雅	台南人
关西镇	行政区划
刘冬	人物
高克毅	记者
周昌贡	官员
徐复观	党员
806年	年
陈德亮	气象学家
欧阳德勋	主持人
张小玲	人
王万宾	人
赵少咸	人
宋永清	人
程郑	商人
蔡启塔	市长
周本立	人
罗马奥林匹克体育场	足球场
吴廷琰	领导人
洪洙贤	人物
严东生	副会长
蒋垣	人
沙丁胺醇	醇
普惠寺	佛寺
柴松岳	省长
杨简	医学家
蒋抑卮	杭州人
Ū	字母
朱孟依	委员
赵允义	委员
王天培	人
杜履谦	党员
李延考	遇害者
陈克正	人
620年	年
张俊雄	秘书长
丁东浩	运动员
沈伟	人
陈贝儿	主持人
迪欧	人物
田村亮	艺人
王光	委员
温源宁	人
萧马	人
妮莎	维拉
江端仪	人
柯布连	官员
方先之	医学家
周力	大使
王政	人
严端	人
徐芳	无锡人
张子健	人
谭维	人
历史学	哲学
杨秋玲	演员
沙流郡	郡
金波	球员
苟利军	秘书长
李开复	雇员
王艳玲	校长
孙翠凤	台湾人
杨与龄	四川人
林建山	党员
西施	人物
林聪贤	党员
崔冲	人物
陈子超	球员
陈永发	研究员
153年	年
赵君陶	人
陶峙岳	人
颜云年	人
邵循恪	法学家
江启臣	人
李作舟	人
赵乐秦	人
蔡豪	党员
黄振世	人
干诺道	道路
许分	参与者
柳清臣	人物
包兆龙	企业家
满泰	人物
当代艺术	艺术
青木一男	企业家
汪民	人
田鹏飞	人
朱存理	苏州人
张文环	作家
岩崎良明	人物
何超明	人物
高振鹏	演员
吴伟超	运动员
刘少奇	受难者
乙二醇单丁醚	乙二醇醚
李碧葱	商人
1911年	年
叶辅平	牺牲者
陈方安生	议员
蒋洁敏	副省长
张英才	艺员
林岭东	人
冯应榴	人
刘焕民	部长
乐美森	华人
李异	人物
张耀曾	人物
严崇经	议员
孙振田	人
张婉婷	获得者
吴昌征	队员
吴一元	按察使
周凤翔	人物
江良规	人物
蔡用锡	人
陈李济	最
刘蜀永	教育家
王亢沛	人
于俊波	演员
赵志鹏	球员
张宪义	人
麦嘉华	经济学家
高钧贤	主持人
黄毅	部长
李斯丹妮	演员
李喜	人
乌古廷	人物
邓月楼	秘书长
焦利	副部长
周绍良	红学家
纳里尼奥省	行政区划
赵贞吉	人
白珊	四川人
龙庄伟	副省长
张山	人
黄紫娴	配音员
黄楼镇	行政区划
卓琳	人
千灯镇	行政区划
大众文学	文学
伊藤哲朗	人物
薛光林	商人
范祖干	人
申佳胤	诗人
梦雪	主持人
喻红秋	部长
曹永廉	主持人
倪宗正	余姚人
吴征	企业家
邓桥村	行政区划
张壁村	行政区划
大涌镇	建制镇
隆城郡	郡
阿塞尔	历史学家
赵信	人
封锡盛	人
费英东	人物
陈琬琛	议员
范缜	哲学家
王霏霏	人
李嘉廷	委员
江志伦	配音员
吴渊	议员
傅鼎铨	金溪人
王贞庆	人
李纪恒	港人
沈括	人物
王商	人物
辛流形	结构
胡安国	人
吕本	余姚人
武新宇	委员
花泽香菜	艺人
沈家铭	农学家
刘宗林	人
郭大诚	获得者
斯劳	管理区
李云迪	人
推迟势	势
虞洽卿	人
190年	年
萨拉丁	库尔德人
黄岳	余姚人
李继迁	人
释星云	党员
杨景尧	家
纪思道	记者
洪英姬	人物
傅家谟	人
伏尔泰	思想家
汤唯	人
伍弥泰	人物
杨秉璋	人
张景森	委员
慈禧太后	皇后
古典音乐	娱乐
古巨基	商人
倪光炯	物理学家
泥塑	雕塑
彭醇士	诗人
阳江市	城市
谢素台	河北人
天满桥	悬臂桥
萧邦表	公司
杨度	人
马加丹州	行政区划
于新博	演员
东莞站	车站
韩英杰	武术家
杜环	旅行家
晏廷爱	大使
黄玉堂	人
陈文静	艺员
孔炯轸	演员
成龙	获奖者
安亭镇	行政区划
沙头镇	行政区划
王梦尧	人
何季麟	开封人
余萧客	作家
费锡章	人
谭良德	成员
白沉	人
叶静子	客家人
施之皓	运动员
施福珍	主持人
李特	霍邱人
天目山路	道路
王匡	泰安人
刘恕	高安人
崔颢	开封人
张翎	华人
储雄文	举人
王定安	使
李宗仁	人物
张海鹏	死刑犯
向文琳	武术家
海螺沟	最
白鹰	四川人
刘英杰	人
喻绍泽	演奏家
砂金石	宝石
李明亮	人
吴承贤	演员
吕洪祥	运动员
卢月香	客家人
孙明扬	官员
李昌仪	人物
76年	年
费子贤	人物
赵卓娜	演员
王福元	商人
朱英龙	企业家
张兴	人
321年	年
颜沧波	人
汪大燮	总长
张孝文	学者
乔家才	人
海青镇	行政区划
郑君里	受难者
龚心湛	人
黄雨欣	演员
刘贤妃	人
十六进制	进位制
洪澄源	按察使
常宝华	演员
尹伊桑	获得者
董奇	人
赵安仁	官员
谢文东	辽宁人
王亚南	校长
向杰	人物
于小文	委员
奥克兰市	城市
赵敏修	人物
刘敬民	获得者
骆文秀	企业家
积臣	球员
千正明	演员
张惟	人
王敏明	逝世者
谢飞	儿子
王德民	科学家
潘云超	党员
蔡子伟	委员
黄顺兴	人
王祖贤	人
王志郁	记者
林金生	镇长
黄仁宇	人
米饭	饭
萧毅肃	人物
鲧	人物
明懿太后	后
白治民	秘书长
黄振世	企业家
张选青	议员
陕甘宁边区	行政区
李好	主持人
奥迪	公司
王效兰	企业家
高桥智秋	人物
何瑭	举人
熊复	副部长
金国泰	人物
赵自强	演员
刘震云	小说家
吴兆骞	诗人
荀子	伦理学家
常恒芳	参政员
李耀文	大使
柳诒征	人
信春鹰	党员
子韦	人物
李诗豪	物理学家
郑芝虎	人物
郭泰祺	大使
侯孝贤	工作者
华夏出版社	出版社
石川铃华	人物
兰洋镇	行政区划
孙威	人物
汤洛雯	演员
刘厚总	人
冯秉芬	议员
石川桃子	配音员
黄淑仪	人
徐有贞	苏州人
林曼丽	人
脱氧鸟苷	核苷
郑群良	副司令员
陈再藩	华人
赵权	人物
高凌雯	人
马自达	公司
周玉蔻	记者
耿纯	官员
秦瘦鸥	作家
吴长胜	大使
常胜	漫画家
何丰林	使
福明泰	党员
后安镇	行政区划
日野聪	配音员
亚洲协会	组织
相川七濑	艺人
士壹	人物
周太玄	作家
续范亭	党员
温州市	地级市
元昭皇后	皇后
魏景蒙	杭州人
史俊威	家
李家洋	人
王竹溪	物理学家
任福	人物
弦子	演员
李元元	校长
新华日报	出版物
黄玉荣	演员
郑星	哈尔滨人
周馥	人物
南岳区	辖区
南京中医药大学	机构
Λ	字母
石太铁路	铁路
尿囊素	化合物
白龙	球员
陈逸松	人
叶文玲	人
安士伟	人
杨衢云	龙海人
赵福来	人物
616年	年
徐重仁	企业家
巴戈	台湾人
贾环	人物
乐甫	数学家
刘俐	艺员
卫兹	人物
刘晓忆	演员
李培林	人
王占宝	校长
巢湖市	行政区
白震	人物
朴智星	运动员
韩子高	官员
李伟光	华人
叶文辉	主持人
李富成	法学家
海南省	行政区划
鱼玄机	人
千叶纱子	人物
郭树德	委员
陶乐县	行政区划
彼得	人物
李培根	校长
余镜清	议员
Ž	字母
黄克立	委员
颜晓菁	议员
李宏毅	人
朴孝敏	人物
李梅菊	运动员
王欣	辽宁人
夏绿	小说家
白治民	副部长
胡台丽	人
大冢明	漫画家
椒江区	市辖区
傅斯年	教育家
冯培恩	委员
韩高恩	演员
黄安	人
何政军	演员
陈撄宁	会长
江田五月	议长
李建保	南昌人
林微音	小说家
陈哀公	人物
彭鹏	人
曾建华	漫画家
周保中	校长
钱熙祚	人
戴旭光	委员
丁善理	企业家
黄胜	人
罗学瓒	家
都统	都统
原研哉	艺术家
闵贞	南昌人
杨贵媚	获奖者
郑贞文	化学家
郑明训	议员
郑文宽	官员
吴一元	使
王瑞祥	委员
毛梦漪	人物
玄阙州	行政区划
王潮	人
陈崇	人
神谷浩史	配音员
吴耀明	商人
陈荭	校长
刘授	人
林俊宏	人物
李思谏	使
郝秀山	人
毕文静	运动员
134年	年
段玉裁	学者
王鉴	苏州人
徐俐	人
群马县	县
林国华	林家
郑南榕	家
郑宇	演员
杨琪良	人
桓熙	人物
梁国权	商人
成龙	获得者
固原市	地级市
晏斯盛	举人
明成皇后	人物
陈智雄	受难者
朱慧敏	人
钟建民	登山家
治河渡镇	乡镇
舒衡哲	汉学家
邬丽珠	演员
中华人民共和国外交部	机关
卵磷脂	磷脂
童杭时	参议员
裘锡圭	文字学家
滨海新区	试验区
刘维炽	台湾人
新世纪出版社	网站
施肇基	总长
凤凰	鸟
刘楚玉	人物
潘迪	作家
黄洪涛	球员
永州	行政区划
李玉妹	部长
张作霖	使
蒋民华	校长
吴道镕	人
左辅	人
梁舜燕	演员
云中鹤	恶人
毕振姬	使
爱立信	公司
木子	人
邱太三	人
魏旋君	党员
王良	党员
刘锡津	作曲家
1972年	年
刘文岛	市长
范继英	部长
许朗	运动员
陈大为	诗人
张家宜	校长
氢碘酸	无机酸
干宝	作家
陈东	人
李英勋	人物
栗宪庭	评论家
司马越	官员
满洲里市	城市
马懿	厅长
黄定光	人物
张炎元	梅州人
司马文	荷兰人
谷建芬	委员
左延安	企业家
大连理工大学	机构
郑君炽	演员
波尔布特	人物
张富生	人
谭志刚	主持人
戴戟	人物
赵岐	经学家
谭晓林	南昌人
李存信	舞蹈家
黄丽梅	评论家
林子祥	演员
高惠宇	主持人
马廉	小说家
章仁香	人物
李仁元	人
房俐	秘书长
李则望	大使
李野	运动员
刘景素	人
张俊	人物
伍佰	家
林遵	逝世者
萨索尔	公司
徐汝澜	人
郑余镇	市长
张伟忠	宁波人
堂本光一	人物
姜春云	副委员长
萧观音	诗人
阿特巴拉河	尼罗河
邓发	委员
王玉川	音乐家
苏井观	人物
苏曼殊	人物
东川路	路
张时彻	作家
冯自由	参议员
河泰权	运动员
中国医学科学院	医学院
川荣李奈	人物
尹齐	人物
聂洪钧	委员
虞兆中	台湾人
成秉淑	演员
曹县	县
安民	委员
陈文茜	评论员
宫泽喜一	人物
孙悦	运动员
董潼	演员
1095年	年
张超英	人
阿基师	获得者
汤若望	人物
萍乡市	城市
瓦房店市	市
刘黑闼	人
化隆回族自治县	县
黄露瑶	台北人
饶雪漫	人
王毅	会员
刘达临	性学家
工藤静香	演员
燕国	战国
李芳	人
赵绪成	专家
郭生练	水文学家
陈岩	人
赵盛奎	人
薛齐	官员
吴禄贞	云梦人
魔王	电视剧
钱敏	市长
滦州	州
邓廷桢	家
杜帅帅	运动员
谷牧	领导人
太田朋子	遗传学家
郑松岩	人
李允成	人
交换图表	图表
那志良	专家
薛仕凌	家
李承铉	演员
林强	获奖者
潘洁	学者
金朝文	人
周秀娜	商人
李彩华	艺员
丰熙	宁波人
陈介生	人
峨山彝族自治县	县
堂本光一	艺人
台灯	灯
吴英	企业家
乌达区	辖区
王正谊	党员
曹操	人
高俊文	艺员
刘山青	成员
姜宏模	人物
王韬	人
马天水	委员
水星	行星
崔恭	使
1643年	年
陈兴良	法学家
孙玉庭	使
情书	电影
梁耀燮	人物
1761年	年
段思平	人
乐正姓	复姓
吴光正	人
鲍文杰	人
许世瑛	台湾人
劳改营	集中营
杨慧	官员
当涂县	县
谢道时	化学家
金炳万	人物
吴一元	人
魏德圣	人
吕旷	人物
佛堂镇	古镇
颜乐枫	球员
李艳秋	演员
人民网	网站
元顺	人物
黄世平	运动员
陈志坚	研究员
吴曼青	人
彭雪玲	人
种咏	人物
冉求	人
林国柱	萧山人
陈火泉	小说家
蔡锷	议员
江连福	党员
李培林	委员
马勇霞	官员
冯梦龙	剧作家
许丙	人物
张思之	者
金灿宇	人物
森尾由美	演员
张支铁	州长
卫嗣伯	人
小娴	运动员
福田赳夫	人物
詹逊	官员
758年	年
李国治	音乐家
李德宏	官员
比利时法郎	货币
唐丰	主持人
韩非子	法家
刘嘉鸿	人
何德全	科学家
云武道	道
纽伯瑞奖	文学奖
汪应蛟	人
林锦昌	作家
乔羽	人
刘昌林	市长
延国符	委员
西陵郡	行政区划
纳粹德国	政权
吴宏一	学者
徐楚波	人
马克宁	党员
科索沃	国家
王任重	按察使
吴化文	逝世者
张再旺	委员
石修	华人
李敏英	人物
杜宇	运动员
陈漫远	委员
薛福成	无锡人
陈嘉爵	记者
俞涉	人物
闵一得	人物
徐帆	演员
里泽省	行政区划
西南财经大学	机构
杨姬琼	人物
卢志远	企业家
班达亚齐	亚齐
吕金藻	人
高浚	人物
38年	年
王随莲	委员
柴松岳	人
冬狼	狼
荣兰祥	会员
甄子丹	武术家
伍长华	使
西藏大学	机构
小野正利	人物
亚通	公司
陈永祥	委员
张彦珍	副部长
蒋南翔	部长
张裔炯	官员
杨永昌	党员
王侃	众议员
胡杏儿	人
阎维文	演员
游大庆	演员
杨南生	出生
严艺丹	演员
兵库县	县
成吉思汗	大汗
黄树滋	人物
李源根	人物
林彬	主持人
郑大世	人
王守信	官员
梅调鼎	人
傅炯	人
郝柏村	参选人
苏有珍	演员
817年	年
余敏	检察长
玄武区	市辖区
孔繁锦	人
坂田荣男	获得者
1119年	年
苏浩才	作曲家
齐齐哈尔市	城市
秦慧珠	人
王长勇	官员
卢信	议员
厦门航空	航空
翁虹	艺员
吴美筠	诗人
张令仪	人
杨元元	官员
鞠李瑾	球员
罗惠珍	家
喻绍泽	人
母德纯	人
林中	大使
藤村修	人物
孙嘉绩	人
王度庐	人
李广	人物
詹伦豪	守门员
筱俊亭	演员
野泽那智	演员
巴特尔	委员
布泽县	县
贺知章	杭州人
卢子跃	副省长
陈荣凯	人
周学铭	使
张学武	企业家
燕尾服	礼服
施补华	人
李相熹	人物
傅玄	诗人
合肥市环城公园	公园
有限公司	公司
吕梁市	地级市
林芳郁	院长
黄元申	人物
万绍芬	党员
郑斌	人
羊欣	人物
陈婉娴	成员
林俊宏	球员
谢正浩	司令员
施智	举人
平野绫	获得者
张厉生	秘书长
胡守仁	人
李明彻	天文学家
杨春	人
扬州八怪纪念馆	纪念馆
727年	年
钱复	局长
田余庆	人
释慧律	人物
古尔露	政治家
麒麟座	星座
张石山	小说家
桓郁	人物
周晋镳	人
方纪	作家
陈能宽	物理学家
夏昶	人
北江区	行政区划
陈谨	人
海南区	辖区
黄元御	医学家
胡明	委员
辛志平	人
水谷优子	配音员
刘伟	演员
张村乡	行政区划
张格	官员
齐如山	剧作家
唐晓程	运动员
王仕俊	人
625年	年
潘廷逢	学者
张永祥	获得者
米洛斯岛	火山岛
司马南	作家
李恩霖	商人
徐河俊	演员
曾庆瑜	港人
郑礼骞	球员
高君宇	委员
贺安杰	官员
林荣德	台南人
张怀西	副省长
归亚蕾	获奖者
马林	人物
胡赐道	客家人
戴德	人
何冲	运动员
萧国健	历史学家
蒙素芬	人
朱丽兰	化学家
梁艺龄	艺员
张江汀	人
林敬益	成员
赵侗	人物
冯巩	获得者
卢弼	历史学家
金信	议员
王文杰	演员
卢祖尚	人
卢秀燕	记者
李祖夔	宁波人
颜文闩	记者
陈洁如	宁波人
杜玲	商人
桥瑁	人物
张知寒	墨家
严秋华	艺员
荣泉	人
李心洁	华人
蒋作斌	官员
于志刚	校长
奚冈	篆刻家
郭启俊	人
史良	领导人
傅作义	人物
温宪	官员
公子池	人物
许世昌	人
孙锐	人
新凤霞	演员
褚益民	委员
宇文胄	人
陈玉勋	活动家
马德新	学者
傅履仁	华人
邓丽欣	演员
戴钧衡	作家
周婉窈	研究员
汤志伟	获奖者
陆宝	藏书家
刘有成	人
魏云	演员
杨献珍	哲学家
陈难先	会员
程容	委员
诸志祥	人
广州日报报业集团	集团
金钟泌	人物
邝富灼	语言学家
陈宗宏	球员
赵逢龙	人
刘正彦	物理学家
大仲马	剧作家
陈淑华	人物
寿光市	市
赵普胜	人物
侯方域	人物
汉源站	车站
蒋友柏	华人
张曜	使
布丰	作家
吴谦	人
秦宇子	人
张德彝	家
马得臣	人物
姚梁	人
贾谊	作家
陈东升	企业家
宇文柔奴	人物
梁博	吉林人
腓力二世	君主
阳建福	球员
苗发	人
郭东坡	委员
罗亿诗	演员
张树新	企业家
赵国红	官员
吴毅臻	球员
陈中	运动员
练市镇	行政区划
张清	人
经元善	商人
吴富善	政治委员
王昭远	人
西彭镇	乡镇
张偃	人物
姜成林	生物学家
蒋孝严	部长
王怀俊	委员
彭祖意	人
编剧	电影人
公孙段	人
尼日尔	政权
后藤邑子	人物
钟志明	司令员
鲁日蒙	市镇
天心区	辖区
德城区	辖区
薛利	人
潘宗光	议员
黄籍	户籍
何九云	人
郭邻	举人
陈邦传	人物
玄奘	僧人
梁兴昌	配音员
叶家宝	商人
唐英年	司长
伊藤圭介	人物
钟正明	生物学家
范慧娟	发言人
图书馆学	科学
徐忠信	演员
孙祜	画家
陈家祠	宗祠
张穹	人
乔森潘	国防部长
陈衣凡	大使
黄健强	配音员
罗振邦	运动员
周秀兰	素食主义者
柯叔元	演员
吴野松	官员
林衡	人
史英	主持人
李濂	开封人
马世忠	长
何家栋	小说家
杨石先	化学家
陈文媛	商人
屈万祥	委员
陈政高	省长
郑思森	指挥家
吴振伟	党员
张帝	委员
王贺胜	官员
张弘	人物
卓慧敏	主持人
周国泰	科学家
宋国	战国
单群	性质
王季烈	议员
周慕冰	董事长
李建勋	广陵人
坂井政尚	人物
陈师曾	客家人
德钦党	政党
漾濞彝族自治县	自治县
邹强	人
花杰	人
赵亮	演员
章志文	演员
韦悫	会员
张彖	人
伍家辉	华人
卢志强	企业家
许仲林	委员
李志亮	议员
731年	年
赵少昂	人
刘杰	主持人
柳孝荣	人物
江青	获得者
黄水郡	郡
水葬	丧葬
黄屯镇	行政区划
龚鼎	漫画家
水杨酸	酸
高幸枝	演员
卫哲治	人
郝天挺	人
卢声亮	县长
监察院	机关
杨向奎	历史学家
聂安达	艺员
任雅相	宰相
朴明哲	人物
王宠	苏州人
伊藤贤治	家
汤晓丹	华安人
叶秋原	记者
秦秉年	收藏家
罗伯聃	人物
洪腾云	人
李旦	人
郑和	旅行家
彭楚藩	人
朱星	委员
郭竞坤	人
朱希祖	人
卞之琳	家
柯俊雄	获得者
沃夫加	国度
王家瑞	委员
吴玉琴	党员
普乐道	道路
李筠	人物
噶尔丹	人物
李尔王	戏剧
朴秀林	人物
张少华	人
李瑞清	家
薛香川	秘书长
铜陵市	地级市
李寰	人物
郭茂林	人
顾贞观	无锡人
何建军	作家
蒋光超	获奖者
李毓佩	作家
萧江镇	萧江镇
南薰礁	暗礁
彭丽媛	夫人
解学龙	人
王顺友	人物
詹志文	商人
潘志文	主持人
张澄基	人物
刘建国	党员
张庆黎	委员
刘桂五	人
彭宁求	诗人
利良奕	人
张安平	企业家
梅渚镇	行政区划
高允权	官员
王小云	科学家
邵名正	法学家
蛇蝎美人	专辑
关际泰	举人
廖烈科	银行家
张郎郎	人物
胡法光	议员
孙秉熙	人物
朱骏声	苏州人
许廷桂	人物
杨璞	球员
郑开文	通海人
李壮飞	球员
王静康	人
邱义源	人物
宣州	行政区划
鲁迅	者
赵同	人
卡里尔	球员
何思谦	澳门人
萨克岛	群岛
郑铮	运动员
薛凌	人
肖里	人
绥江县	县
闵尔昌	历史学家
郑社奎	人
叶兰舫	人
厉娜	演员
王伟忠	人物
平山相太	运动员
吴忠信	委员长
徐明华	市长
魏恭帝	人物
文祥	人
陈守一	法学家
白坚武	人
K	电影版
邱比	作曲家
庄长恭	人
乌马河区	辖区
刘应宾	使
丘凯敏	作家
成之凡	哲学家
时铭显	常熟人
龚晓南	科学家
永红区	市辖区
陶飞霏	人
段灼	人物
萧朝贵	人
向达	家
张伦硕	演员
唐鱼	鱼
王学文	委员
黄嘉威	艺员
杨冠军	人
康斯坦察县	行政区划
龚遂	人
铃木惠子	人物
彭述之	委员
薛浩然	成员
亚丑	国家
辛庆忌	人物
周文重	大使
宣武区	辖区
戴有祺	人
陈训慈	历史学家
陈志光	运动员
魏应州	企业家
陈川平	官员
段跃庆	大理人
万斯大	经学家
阿拉伯语	语言
郑文龙	参与者
洪兰友	党员
钟利俗	人物
康朗	使
王三善	人
甘婷婷	人
黄如论	商人
洪长有	委员
李刚	司令员
白南云	人物
刘鸿敏	运动员
吴泽刚	副州长
施济美	人物
世界贸易中心	大楼
冯国经	华人
磷酸脲	脲
唐志顺	活动家
刘晓明	大使
陈朝容	委员
谭敬昭	诗人
郑萃雯	福建人
王云程	委员
吴育	人
赵光华	委员
钱振常	人
黄长兴	主持人
谭美琼	人
宋时烈	人物
辽宁省图书馆	图书馆
许渊冲	家
钟亚瑟	客家人
拉斐尔	角色
刘守通	人物
百灵达	公司
王图炳	人
吴芮	人物
张锋	科学家
赵学斌	运动员
张成烨	人
中央戏剧学院	机构
刘少君	商人
叶以群	家
刘国松	画家
贾至	诗人
模特儿	人物
欧洲复兴开发银行	组织
陈恪三	人
溧阳市	城市
西西	诗人
文翁	人物
童世平	委员
陈叔同	社长
九丹	江苏人
沈曾植	人物
欧鸿炼	党员
峻青	作家
王健林	委员
陈键锋	主持人
运输省	省
卢英学	人物
朴义春	部长
项兆伦	无锡人
张贵妃	人
汤咖哩	咖哩
王惠美	议员
谢雪红	公民
梁嘉琪	演员
刘孟合	人
青鹭火	鸟
张联升	人
林文兴	议员
苏贞昌	委员
月氏	国家
无色	颜色
郑少伟	球员
佟健	运动员
赵镇	人
潘翰声	党员
常青	建筑学家
北宫纯	人物
子西	人
车得基	人
那彦图	会员
刘敬宣	人物
钱大昕	历史学家
安胜浩	人物
太田雅友	人物
吴铁城	长
南康郡	郡
黄英贤	参议员
董作宾	所长
2015年	年
蔡潆萱	人
低级语言	语言
查懋成	商人
莫子纯	余姚人
胡立成	配音员
林崇中	官员
老舍	委员
白塘镇	乡镇
石井贵	球员
周伯敏	家
吴觉农	委员
晋夫	人
陈新滋	人
陆武成	人
中村庆子	主持人
屈映光	会员
郭霸	人物
许杰辉	制作人
吴沛宁	主持人
李进才	人
863年	年
蔡冠伦	人物
刘大庆	商人
金淘镇	乡镇
高晓兵	副部长
陈幸婉	画家
孙光祀	人
张耀坤	球员
朱丝纶	人
刘殿爵	哲学家
安徽省政府	政府
陆忆敏	诗人
赵紫阳	者
严慧秀	严家
裴得宣	人
常万全	委员
石晓	政治委员
德山藩	藩
宗秦客	人
黄耀江	运动员
黄越钦	台南人
蔡啸	台南人
陈绍宽	人
新加坡外交部	机关
高文虎	宁波人
苏肇冰	苏州人
陶保晋	南京人
集美区	辖区
王檄	运动员
萧子明	人物
熊廷权	人
钟祥市	城市
陈文辉	运动员
黄伟光	委员
权相佑	演员
霍刚	作家
娄烨	获奖者
原鹅龙	恐龙
山东人民出版社	公司
覃修典	水利学家
黄启瑞	党员
樊弘	委员
寇世勋	演员
马纪壮	人物
徐国梁	人
斛律金	人物
秋元康	获奖者
柏小磊	运动员
黄敬佩	人
王秋湄	人
张太和	人物
申行运	大队长
典型群	李群
麦家琪	参赛者
原哲夫	人物
蒙戈	独裁者
丁明	人
张子谦	人
许景先	文学家
张崇基	演员
丁磊	家
阿拉伯半岛	半岛
徐树敏	人
胡其俊	举人
高锐	物理学家
李安泽	市长
徐世昌	人物
黄维义	委员
陈尚文	委员
张弘范	人物
吴仁静	官员
公孙友	人
马国器	人
林士元	按察使
余英时	院长
阮有政	人
渝中区	辖区
顾栋高	无锡人
信春鹰	委员
王之都	人
李适	人物
郭台铭	企业家
韩先楚	委员
新泰市	市
亓诗教	人
永州	州
蔡晓慧	运动员
南部非洲	非洲
符兴	委员
常华	大使
祝良	华人
郑永刚	企业家
陈志远	企业家
管阳镇	乡镇
波士顿大学	机构
张松溪	人物
王性尧	官员
郴州	州
萧友梅	音乐家
郭林勇	党员
朱丽	企业家
K	人物
卞荣泰	人物
玛德	大使
朴诚雄	人物
刘聪	弑君者
卢于道	人
黄敬	党员
陈泰贤	演员
林玉珍	南投人
陈凯韵	记者
杨玉梅	华人
胡济邦	人
拉巴平措	委员
高琛	官员
赵先顺	委员
林信义	部长
吴伟	画家
王素筠	党员
1267年	年
明庆陵	陵
826年	年
吴式芬	按察使
区适子	顺德人
王双	哈尔滨人
陈弘平	市长
王重民	作家
朴孝信	人物
陈志远	人
清朝	帝国
陈金茂	人
金同稷	人
王同春	人
菱形	四边形
黎灼灼	艺员
周一波	人
柳文扬	作家
玉泉区	辖区
刘兆麒	人
罗竞	球员
劳剑峰	运动员
深圳经济特区	特区
赫德	使
卜兆麟	人
曹安民	人物
高逊志	人物
夏偕复	企业家
朱宗元	人
民主党	网站
道信	人
傅培梅	逝世者
虞海燕	副省长
李竞	余姚人
刘秀梵	委员
1804年	年
丘逢甲	人物
成克杰	官员
星震学	天文学
薛寿生	无锡人
程大昌	人物
梁灏	人
戴安国	董事长
任夔	人物
胡秉钧	人
郭有明	副省长
李熙谋	校长
陈任	主持人
奎文区	辖区
袁咏仪	演员
黄樵松	人
赵常玲	人
王圻	人
宋建成	学家
刘德培	人
李蓝	委员
杨朝祥	学者
佟国瑶	人
林晓培	客家人
池田纯矢	演员
王之卓	地质学家
陈光林	委员
百脉泉	名泉
多值逻辑	逻辑
吴泳	人物
杨宗仁	人
黎银	官员
林振国	董事长
奥仲麻琴	人物
金万重	作家
李端娴	作曲家
张小燕	经纪人
博陵郡	行政区划
俞允	人
白岩松	主持人
古廉权	运动员
向明	诗人
刘弘道	人
魏群	会员
定海区	市辖区
黄长兴	人
林挺生	人
戴娇倩	演员
孟喜	学者
畸胎瘤	肿瘤
29年	年
王晓龙	球员
陆定一	无锡人
司马华龙	艺员
林准	人
麦基华	科学家
黎族	民族
谢冰莹	小说家
权泰元	演员
陈慧楼	演员
藤木禀	作家
乙硫醇	硫醇
黑木瞳	人物
区宗杰	人
区	行政区划
浙商	企业家
中南财经政法大学	机构
启	人
曹洪	人物
下龙湾	北部湾
陈泮岭	教育家
范华平	市长
成世光	人
施廷懋	人
徐鼐霖	使
永璇	人
228年	年
席上珍	人
赵周	人物
海陆	演员
森兰丸	人物
詹明信	评论家
巴东县	县
芦名星	演员
秦基伟	政治委员
李国昌	人物
韩俞	人
黎栋国	局长
何鲁丽	领导人
安慧京	人物
王瞳	演员
施文彬	人
济源市	市
辜鸿铭	人
董钥	人
张富美	委员
邓力群	人
李易	播音员
黄威	运动员
李丹	运动员
郑亦同	委员
仓科加奈	人物
香田晋	人物
高健	委员
张万有	漫画家
朴哲镇	球员
于魁智	委员
陈敏	音乐家
奎屯市	市
鲁培军	余姚人
吴朝晖	温州人
王秀红	委员
黄跃金	副部长
张勇	人
宝杨路	道路
蒋勤勤	演员
崔南善	人物
林森	委员长
潘超然	球员
电车男	电影
岳文海	人
池大雅	家
赵深	无锡人
林慎思	人
南威岛	南沙群岛
宋庆龄儿童文学奖	文学奖
核子	重子
姜大卫	艺员
曹卫星	农学家
冲绳县	地区
曹西平	主持人
酆悌	人物
张研农	社长
山国	地区
翟耀辉	演员
郑大进	人
伊罗生	人
英韬	人
吴庆坻	使
杨士聪	官员
1126年	年
李嘉廷	官员
郑耀宗	校长
西村博之	人物
南海	陆缘海
李翔	记者
张克让	演员
朱克靖	人物
杨联升	汉学家
冯忱	人
离石区	辖区
2021年	年
蒋超良	董事长
颜惠庆	市长
赵黎平	作家
毕鸣岐	企业家
林牧	官员
李寿雍	校长
嘉罗	演员
秦榆市	行政区
李宗伟	人
卓志强	厅长
李再勇	人物
范长江	社长
孙越崎	委员
王汉斌	领导人
贺安杰	人
王学兵	人
杨刚	官员
冯淑萍	委员
刘贤	人物
伯丁罕	公司
傅明宪	艺员
范亚峰	人
俞应麓	人物
王景禧	议员
张毅	专员
张衡	官员
池春红	人物
寇赞	官员
丙烯酸乙酯	乙酯
慈运理	人物
朱祖祥	农学家
金莎	演员
郭卓桦	艺员
郑幸生	球员
米迦勒	角色
刘兆佳	社会学家
佟麟阁	人物
关牧村	人
高塘郡	郡
方念华	主持人
张奂	人物
王毓祥	人
成武县	县
钻石	宝石
刘英	人
李季兰	诗人
董军	市长
洮北区	辖区
刘玉翠	艺员
特土良	人
李红民	彝族人
利穆赞	行政区划
黄旭东	人
西川路	路
25	专辑
阎连科	人
周珏	人
聂永真	艺术家
彭占元	议员
李载义	使
杨守愚	家
田丁	大使
联合国	观察员
晏城镇	行政区划
金敏智	运动员
李敖	哈尔滨人
郝仲青	参议员
董竹君	企业家
牧野伸显	幸存者
韩喜凯	人
潘阳	吉林人
王选宏	球员
李际期	人
陈敬熊	物理学家
陈竹升	演员
郭玉祥	政治委员
邓志伟	障碍者
异或门	门
沈起凤	人
谢志伟	台湾人
伊藤淳史	演员
郭椿森	会员
桂柳话	官话
萧子云	家
汤德全	人
李雅景	议员
杨一虎	人
李润华	运动员
姚金男	人
魏琮	人
蒋舒	人物
丁一汇	科学家
杜卫	委员
徐树本	人
1608年	年
张佑才	市长
季武子	人物
李心洁	艺员
邓朴方	儿子
原彻	人物
邱彰	台湾人
颜惠庆	委员
李璧琦	演员
乌日图	人物
睡莲	作品
洪瑞河	企业家
王景唐	学家
尹奉	人物
李铸晋	艺术家
熊小芸	演员
郑雪来	家
周玉堂	成员
广金岛	西沙群岛
谭雄	人物
薛禄	人物
贾占波	人
王海涛	副参谋长
闸口镇	行政区划
蒋孝严	委员长
张镜心	人
李开复	人
梁国斌	副部长
倪岳峰	委员
沈俊	守门员
永安乡	行政区划
邓析	人
巴孛	创始人
李建中	家
宋时选	人物
钱其琛	台湾人
刘瑞祺	按察使
云梦公主	公主
曹云祥	嘉兴人
周本立	官员
丁一权	人物
廖亦武	作家
卢文舸	副省长
李钟硕	演员
施治明	市长
1239年	年
唐贞陵	陵
海宁市	市
金元弘	委员
王蒙	画家
孙维栋	人
78年	年
杨世	人物
朴海美	演员
刘镇华	人
胡仲持	记者
赵俊	人
联想集团	公司
林佐民	人
钱三强	校长
黄子卿	人
崔斌	人
李祥霆	人
周百炼	人物
张心宇	主持人
朱凤芝	台湾人
商均	人物
宋涛	副部长
郝柏村	侍卫长
胡利德	无锡人
陈虚谷	小说家
林元美	人物
雨海	月海
陆小曼	党员
铃木大拙	人物
张启元	人
王华元	人
张莉	企业家
马殷	人物
蒙化府	府
王雷	人
马里	国家
袁中道	人
谢德庆	艺术家
300	漫画
黄金福	运动员
刘焘	人
吴银善	人物
黄汉勋	武术家
吴瑛	人物
牛佩琮	受难者
韦建桦	副局长
刘牧	演员
喜多郎	作曲家
兰茜	画家
唐晏	作家
麦皓儿	人
祝贡寺	佛寺
五家渠市	市
东安县	县
王从礼	人
连温卿	人物
陈琬琛	成员
囊谦县	县
旧州镇	行政区划
杜子春	经学家
吴锦堂	企业家
尖扎县	县
金日成综合大学	机构
察哈尔右翼后旗	旗
河东郡	郡
陈南禄	作家
陈舜臣	获奖者
唐毅	武胜人
杜兰线	分界线
孙建国	副参谋长
杨钰莹	南昌人
古懿	者
吕颂贤	客家人
巴菁子	配音员
杨绣惠	演员
卢世荣	人
费信岛	南沙群岛
高纪毅	人
陆郁生	人物
王鸥	演员
檀润华	会员
王孝廉	作家
郭树清	局长
赖慕布	人物
李泽钜	华人
陈能济	作曲家
葛剑青	艺员
龚学平	南京人
陈文清	检察长
袁利群	宁波人
曹丕	作家
王翦	人物
胡兆康	运动员
李元胜	作家
老舍	学者
项伯	人物
谢容儿	人
李敏	按察使
双面	剧集
陈君乐	记者
金天泽	诗人
李邦华	举人
李屋乡	乡镇
俞鸿钧	院长
费正清	人
沈玉琳	演员
石德懋	人物
张扬	作家
李殿林	翰林
郑姝音	人
书昌	人
叶皓	大使
马甸桥	桥梁
陈志强	球员
陈招娣	逝世者
余绍宋	家
张韦怡	艺员
Ş	字母
严绳孙	诗人
苏果超市	公司
王世贞	使
潘丽丽	演员
叶金川	党员
罗宇	人物
王安顺	委员
Ў	字母
邵洵美	宁波人
周德兴	人
刘晓妹	运动员
刘典	人物
刘光磊	厅长
李允成	企业家
江钰源	柳州人
伍奢	人
丫子	艺人
蔡廷干	总长
范玮琪	台湾人
洪绮敏	记者
雷经天	校长
景章	富顺人
黄家定	部长
袁士元	诗人
李六如	党员
何贤	人物
李明启	演员
蔡子民	公民
北京西站	车站
凌廷堪	人
郑公智	宁波人
马希杲	人物
归仁泽	苏州人
朱裳	人
黄志鸿	获奖者
林翼中	人物
魏谟	使
杨奇志	演员
黄文耀	云林人
黄任恒	历史学家
原敬	议员
伍乔	人
李富孙	嘉兴人
梅世彤	市长
天心	获得者
邢崇智	委员
程士范	人
叶建源	成员
渡边华山	人物
小雪	人物
米露	人
利特	演员
竹野内丰	人物
赵源熙	英超球员
唐敖庆	校长
麦喜俊	华人
奥姆真理教	组织
钟兴民	获得者
湖州市	地级市
博古	人物
李孟	人物
曹磊	人
王童	获得者
资州	州
高宪	人物
改则县	县
王昭耀	副省长
施启扬	党员
黄天化	人物
徐恪	使
张琪	慈善家
阮泊生	人
东塘镇	行政区划
郑廷珍	烈士
进修学校	学校
梅林	人物
岛津义弘	人物
萧家淇	局长
林野	委员
胡一川	画家
刘伟平	委员
汤一介	人
相里斌	人
吕雉	人
赵占魁	党员
马福兴	人
阮浪	建筑学家
谢承均	主持人
树仔镇	建制镇
侯昌明	主持人
罗复堪	顺德人
袁隆平	人
杨蕴玉	副部长
张悬	台湾人
包天笑	剧作家
黄华	人物
费景汉	经济学家
蒋中正	校长
黄康生	委员
卢忠良	委员
卢湾区	辖区
张峻宁	艺人
赵盾	人物
许艺娜	人
谢子龙	人
薛凌	人物
刘玉浦	学员
公何藐	人物
黄海冰	演员
阮武	开封人
彭佳芸	记者
黎德英	人
苏竟	人
周杰	举人
康海	作家
崔休	人物
李梅树	台湾人
许冠英	演员
面试	考试
鲁炜	副社长
龙岩市	城市
缪辅	苏州人
张锡俦	副局长
寻阳郡	郡
大港区	行政区划
滕丽名	艺员
郑敏	作家
杨茂元	人
广濑香美	人物
张耀栋	演员
何家劲	艺员
廖亦武	人
叶振棠	澳门人
高育仁	县长
电钢琴	钢琴
渡边华山	文人
张广泗	按察使
邱园	园林
谭本宏	司令员
唐翼明	家
李钟原	演员
英士村	里
雄蕊	性
刘家辉	武术家
曾月娥	演员
王象恒	人
黄韵玲	制作人
屠寄	理学家
梁维东	佛山人
刘天华	音乐家
赵永洪	艺员
吴国伦	人
宇文颢	人物
法隆寺	最
王思平	演员
范文澜	历史学家
赵弘恩	人
砂岩	水成岩
陆志豪	华人
杨勇	委员
Ћ	字母
邓鸿	人
五营区	辖区
新兴区	行政区划
园田直	委员长
关悦	演员
蔡睿贤	人
王文杰	临沂人
郑成龙	球员
沈云英	萧山人
甘乃威	成员
车向忱	教育家
夏煊泽	运动员
姜逢元	余姚人
刘知远	人物
宋希濂	获得者
顾秀莲	人
何基沣	人物
白春礼	委员
蔡儒楷	使
张炳良	校长
三影塔	砖塔
原辰德	人物
杨君	人
苗侨伟	人
冯绍正	人
空中客车	公司
布伦丹	探险家
罗尚才	委员
杨正午	人
曹登昌	制作人
叶先圻	议员
郭洁	运动员
邢慕寰	经济学家
边熙峰	人物
潘祖荫	举人
蓝刚	人员
陈国达	地质学家
张卫华	运动员
1232年	年
程颐	经学家
祝良	人
李仲彬	人物
冯家升	社员
江采苹	人
杨森	逝世者
张波	运动员
雷洁琼	活动家
云溪乡	行政区划
王玄览	人
张晨	球员
孙光萱	宁波人
周璇	人
贾晓晨	人
薛晨	无锡人
陈昊苏	语者
李肖聃	教育家
张国维	人
方舒	人
杜明洋	球员
楚原	电影人
大仁秀	人
余蔚平	副部长
吉雅泰	人
刘光文	举人
朱祖祥	社员
马灿荣	委员
朱升	学者
王智量	翻译家
言少朋	演员
赵爱武	官员
严家淦	人物
吴甘来	人
山崎正昭	党员
张新吾	企业家
王春正	委员
717年	年
王炳章	者
顾秉林	学者
舒嘉猷	大理人
陈锡嘏	经学家
李思思	主持人
朱保镇	行政区划
段锡朋	部长
千虎珍	演员
花莲县	行政区划
李慧娴	雕塑家
顾仲彝	理论家
Ŧ	字母
关行男	飞行员
吴光伟	河南人
李枫	艺员
李芷麟	演员
盛丕华	人
万妃	华人
夏政峰	演员
蔡瑞月	台南人
彭修文	指挥家
黄辉珍	局长
潘美月	人
徐洋	球员
吴妍华	生物学家
孙季卿	演员
李欣芸	主持人
连岳	作家
彭德怀	委员
范源濂	校长
原干惠	演员
常德	使
阮福淳	人
赵世玲	人物
孙复	人
辛夫人	人物
徐中雄	障碍者
黄安瑜	演员
唐定奎	人
刘澜昌	商人
乐善	人物
吴桓	人
刘继恩	人物
高衍孙	人物
李评	人
曾泽生	人
张俊彦	科学家
羊子乔	作家
张维迎	作家
1207年	年
卢沛宁	会员
印度理工学院	学院
赖幸媛	人物
吕紫剑	证人
街头镇	行政区划
徐贤修	主任委员
荷兰王国	王国
钱宝琛	作家
梁光烈	副司令员
储元升	宜兴人
张灏	人
钱穆	学者
王彦霖	辽宁人
痖弦	南阳人
楼兰	国家
李实	人
李慈铭	人
惠栋	人
谢勇	委员
杭齐苏	人
林文秉	医学家
王刚	球员
陆武成	副省长
刘希平	市长
王红丽	演员
吕良焕	人
杨献珍	委员
五香豆	蚕豆
黄文玲	人
尚州	州
黎锦熙	语言学家
顾崇廉	党员
杨晓君	运动员
思希	运动员
追踪者	节目
格谦	人
徐缙芳	人
伍仲衡	作曲家
邝佐治	华人
西茜凰	作家
师胜杰	演员
小街镇	行政区划
詹夏来	人
徐承云	委员
马祖镇	行政区划
邱太三	委员
邓泽永	市长
电视广告	广告
马可	演员
宋永毅	人
张永义	副司令员
徐勉	官员
殷通	人物
巴代	党员
寺田拓哉	人物
雷宇扬	演员
肌细胞	细胞
高仲勋	运动员
何祗	人物
黎公荣	球员
金剑啸	作家
木德	人物
尹扬明	人
徐景贤	人
陈荒煤	家
铃木美妃	人物
徐辉	人
杨国宗	漫画家
李书磊	副校长
孙维祺	作家
班克斯	画家
虞兆中	校长
彭志铭	作家
马群站	车站
朔黄铁路	铁路
孙来苗	人
秦伟平	人物
洪友崇	古生物学家
王战	宁海人
邵力子	成员
阿尔比	运动员
马恕	举人
洪次玉	运动员
缪斌	无锡人
张世恩	人
石湾区	禅城区
大安山乡	行政区划
马欢欢	人
瓜州	行政区划
李金福	作家
高丰文	运动员
毛远新	人物
杨开慧	人
辛弃疾	诗人
王赣骏	宇航员
刘永山	议员
吴樾	演员
林凡	人
孙锦顺	球员
曾颖如	党员
金荣水	人
吴克泰	者
谢晋元	牺牲者
姜杰	哈尔滨人
傅增湘	人物
柏林站	车站
郑哲民	球员
南阳市	城市
邝山笑	演员
林全	台湾人
叶天士	医学家
青浦区	辖区
有珠山	活火山
徐天荣	剧作家
陈茂辉	人
吴激	人物
米泽藩	藩
李忠熙	运动员
段干木	人物
储望华	宜兴人
人民文学出版社	公司
张建勋	使
闫傲霜	物理学家
林绍文	海洋学家
黄自元	家
蒋梦麟	秘书长
尚慕杰	参议员
王伟	人
马志鹏	人
庄长恭	委员
严棱	官员
许林平	副司令员
王效兰	人
窦店镇	行政区划
四大家族	人物
孙祖德	人物
高继冲	官员
杨绍清	人
公皙哀	人物
吴玉谦	副司令员
蔡名照	记者
冷水江市	市
吉林省	行政区划
曹其真	议员
颜德基	会员
联合国难民署	组织
E	字母
姚建华	无锡人
吕学海	作家
元昊	诗人
吕嘉	画家
张瑾	举人
陈襄	人
马贯东	人
张美翊	地理学家
韩少功	家
蜥蜴人	角色
许广平	作家
徐知诲	使
卢淑仪	参赛者
洋桥	立交桥
邢天正	登山家
李冠丰	人
沈慧莲	活动家
胡光镇	科学家
屠宽	会员
贝恩德	专员
董光清	副团长
马尔巴	者
福音	短语
双溪区	行政区划
任仲夷	人
罗琦	南昌人
泊头市	城市
潘廷章	人物
广宁县	县
许根俊	科学家
张延年	大使
赵朗	举人
乌兰布和沙漠	沙漠
日喀则地区	行政区划
钱德拉	物理学家
孙智敏	余姚人
马士杰	企业家
史念祖	人
任心廉	人
王廷歆	温州人
益州路	路
毕节市	地级市
王杰	运动员
徐生	学者
李明	运动员
161年	年
范寿康	厅长
公子通	人物
元华	武术家
陈星莺	委员
张怀芝	人物
南康	作家
史建勇	人物
陈瑞钿	人物
张小宇	球员
刘春良	秘书长
刘益谦	企业家
袁子钦	人
龚仁心	商人
东安门	城门
傅秋涛	委员
林黛	自杀者
杨忠道	研究员
项武忠	数学家
潘崇彻	人物
纪昀	举人
左光平	主持人
张少怀	人
蒋科	人
蔡晟	球员
西秦	政权
757年	年
多吉	藏族人
明史	二十四史
蔡乃煌	人物
王柯敏	长
吴佩慈	主持人
2013年	年
吴贤	人
张昭雄	院长
陆谷孙	家
魏尚进	华人
罗存德	汉学家
郑梅玉	人
红塔集团	企业
东方玉	余姚人
成吉思汗	参赛者
李李仁	演员
简太郎	委员
弘升	人
杨学山	副部长
马绍宏	人物
于靓	运动员
赵玫	专家
司徒华	作家
新乐市	城市
重子	强子
吴思	记者
江良规	教育家
郑寿麟	家
南沙群岛	群岛
濮院镇	乡镇
温振华	历史学家
2025年	年
朱邦造	大使
赛夫汀	议员
孟穆伯	人
谢南光	作家
孙鸾	人
李建兴	企业家
董恺悌	人
韩鼎祥	人
谢霆锋	华人
徐向前	委员
王克英	副省长
刘烨	人
徐爱民	人物
杨金声	人物
罗传进	委员
林用三	委员
潘	后裔
郑淑珍	化学家
赵家贤	议员
琉球乡	行政区划
梁国治	家
张祯	人
陶启胜	人物
钱松	家
陈晓东	人
尼日尔河	尼日河
摩尔	单位
杂多县	县
洛杉矶国际机场	机场
张庆黎	司令员
公孙武达	军人
陶大为	委员
全怿	人物
王子野	委员
丽娜	人
季国标	学家
徐干学	人
徐祯卿	画家
杜国清	家
陈渊	人物
孟州	州
额尔德尼	人
田流	人
北野武	演员
吴臣	人物
容锦昌	艺员
郭惠妮	记者
卫奕信	人物
蒋法贤	教育家
杨德福	人
车保罗	艺员
精神文明	文明
冯华君	逝世者
周自齐	人
永宁镇	行政区划
朱万年	人
刘宪华	华人
秃鹰	角色
刘戬	安福人
耿雁生	局长
习近平	校长
田仁琬	人物
林献堂	人物
刘德章	人
沈德潜	作家
编程语言	语言
王有兰	台湾人
汪思明	剧作家
俞强声	官员
周瘦鹃	家
黄文玲	党员
吴平	校长
太平岛	南沙群岛
谷正鼎	党员
黄禹锡	人物
赫特贺	人
李子通	人物
唐建武	党员
户松遥	艺人
傅朝枢	人
峻青	人
周恭帝	皇帝
尹力	副局长
蔡世杰	委员
李钟岳	人
高洋	人
赤坭镇	建制镇
索列姆	巨人
郭树清	委员
朱徽	道员
王显斌	制作人
梁鸿华	艺员
卞赓	人
阮海臣	家
成其圣	秘书长
真飞圣	人物
岑珈其	演员
危地马拉	国家
刘文辉	委员
房兴耀	临沂人
余天	主持人
李悝	思想家
李明亮	卫生学家
信阳市	城市
赵振东	人
碳酸二苯酯	酯
王弘	人物
舰载机	飞机
刘温叟	人物
任钟祥	人物
吴中区	市辖区
蒋经国	人
林霭丽	大使
王海芳	运动员
常黎夫	委员
冈村隆史	主持人
季方	副部长
黄兰香	官员
2049年	年
薛贵	蒙古人
分身	作品
侯音	人物
杨建华	法学家
郑思维	运动员
吴立胜	企业家
于飞	市长
明雪	人
宋时烈	自杀者
董恺悌	华人
文森	雕塑家
胡毅峰	人物
许金德	新竹人
任泉	人
马克坚	守门员
黄尔璇	委员
沈彭年	人物
杨永明	局长
杨维汉	艺人
贝允昕	人物
张高勇	盟员
王胡之	人物
刘诗昆	受难者
长兴县	县
余心清	自杀者
刘慎谔	植物学家
张山	演员
蓝荫鼎	画家
财团	法人
闻承烈	威海人
金堤	人
王凌	人物
顾仲彝	家
叶衍兰	画家
高文谦	历史学家
穆闽珠	党员
于帅	球员
奥美拉唑	咪唑
华秀	人
王冠	运动员
高明寺	佛寺
郑孝胥	使
格贺族	民族
张国溶	议员
七台河市	地级市
汪兆镛	人
徐华凤	台湾人
林文	人
齐贤镇	行政区划
杨诗蒂	演员
陈介生	委员
李平	官员
张晓龙	人
连瀛洲	参政员
左宏元	家
张尚柔	人物
古筝	南阳人
王铮亮	人
山名氏	氏
冬至	节日
姜克智	党员
唐德刚	历史学家
释昙宗	僧人
王柏	经学家
李修平	妻子
陈德章	成员
魏志明	政治委员
谢杭生	委员
宝丰	举人
巨蛇座	星座
李巨	人物
于彭	大使
林丰正	厅长
范多富	市长
邵醉翁	人
葛仲珊	音乐家
史致光	人
奥吉拉	地
李占英	参议员
邓鸣贺	逝世者
黄靖伦	演员
韩太湖	人
王涯	人
王廷	人
薛凤旋	福建人
郑愁予	台湾人
伍子胥	人物
王超	球员
刘伟全	党员
阿巴泰	人
叶昌炽	书家
李力持	电影人
叶渚沛	人
严庆龄	企业家
丰臣氏	氏
陆逊	人物
江盈科	人
吴堡县	县
姚建华	人物
潘美月	人物
栗本薰	作家
武治业	市长
费隆	作家
于远伟	球员
溥静	人
黄静波	省长
李济	研究员
段德彰	政治委员
林瑭	侯官人
秦玉海	厅长
张淼	球员
依莱	死刑犯
任心廉	官员
罗建国	厅长
林克	市长
郑小燕	委员
李凡秀	人物
钗	页面
杨邦孝	客家人
唐露晓	人物
郑慧芸	运动员
莫敬恭	人
杭世骏	历史学家
余绮霞	参赛者
蓝正龙	演员
洪致文	工作者
甘宇成	人物
端纳	家
薛驹	委员
舒国治	人
集宁区	行政区
程崇庆	数学家
杨永昌	人
水头镇	行政区划
滕丽名	人员
小野明日香	演员
王秉钧	党员
程克	人物
齐藤祥太	双胞胎
池峰城	获得者
陶短房	南京人
丘凯敏	主持人
杨毓滋	参政员
石瑛	部长
陈端堂	党员
张耀杰	作家
罗志祥	演员
王百得	工人
李畋	人
彭涛	人
金兴贤	艺员
刘彩品	天文学家
盘古	巨人
李经纬	企业家
朴敏雨	演员
李正印	市长
田中实	人物
赵尔巽	按察使
王尧臣	作家
世续	人
王作安	宜兴人
莫理循	人
段祺瑞	首脑
雷延寿	官员
吴建民	南京人
广西壮族自治区	自治区
洪遵	收藏家
记者证	记者
成勇	人
待制	官制
郑天慧	运动员
林砺儒	校长
朱泳腾	艺人
洪升	作家
李琪	运动员
谷祖琳	主持人
刘懋功	司令员
汪可盈	演员
韩瑞阶	司令员
刘子舆	人物
侯伍杰	人
任心廉	经济学家
士仁	人物
刘雨卿	党员
程启光	人物
罗佩怡	主持人
刘兆玄	党员
郝鹏	委员
李珊珊	演员
程鸿书	林学家
马绍文	人
毕研韬	人
陈文述	举人
霹雳娇娃	影集
日本外务省	外务省
廖发寿	人物
曹秉局	运动员
郑岳	使
丁绍祥	人
吴龙翰	人物
鞍山市	城市
徐自华	会员
李叔同	学者
屈庆	音乐家
山玉明	柬埔寨人
刘国庆	副厅长
施勋	官员
李厚洛	议员
保昌县	行政区划
沈丹萍	演员
刘翔	运动员
李心艾	人
吴定富	官员
孔照年	司令员
郑必坚	富顺人
盛子瑾	党员
秘鲁	政权
陶元珍	人
刘锡荣	人
阎振兴	厅长
欧姆定律	定律
王增钵	人
龚书铎	历史学家
437年	年
董寅初	委员
崔曰臣	市长
喻树迅	人
北大西洋公约组织	组织
吴晶晶	作家
刘小龙	运动员
董玮	艺员
夏耕	人
刘国华	记者
张耀	人物
王荣	委员
伍惟忠	安福人
张鸣岐	举人
赵志游	党员
法显	旅行家
樊叔略	官员
宗峰岩	演员
徐镛	人
黄立成	音乐家
塞文桥	桥梁
上海市政府	市政府
邱彦翔	人
李宗恩	委员
谢伯昌	党员
徐明达	学者
达拉拉	公司
张晓晨	河北人
王书麒	主持人
施乐	公司
何帆	人
李虎	运动员
吴展	人
万福华	语言学家
许兆椿	云梦人
白马井镇	乡镇
雍松	作家
司马喜	官员
亚历山大图书馆	图书馆
脸	小说
赵昂	人物
尚钺	党员
李经羲	使
黄树贤	人
刘良模	活动家
薄瑞光	处长
王致	教育家
甄子丹	演员
董显光	大使
韩升洙	部长
郭源治	人
金陵饭店	公司
年维泗	人
程务挺	人物
黄克诚	副省长
李泰龙	成员
贺耀组	人物
黄格胜	委员
黄光亮	演员
王国章	大使
张君劢	哲学家
伦世仪	科学家
华州	行政区划
北京工人体育场	运动场
王祚远	官员
胡斌渊	运动员
杨昌祚	人
林维先	金寨人
王赣愚	政治学家
位	单位
幽州	州
袁霞	演员
陈成	市长
王儒林	官员
魏巍	哈尔滨人
光复节	节日
艳情小说	小说
王维国	委员
花童	儿童
兴义市	市
陈伟	市长
刘丽英	官员
李思浩	余姚人
尹天照	演员
白涧镇	行政区划
社会党	成员
马晋	运动员
白海	巴伦支海
卢凌	社员
黎简	画家
董文驹	人
周永康	人
邱垂益	市长
黄敬平	客家人
李海生	出生
王秋湄	记者
苏俊宾	主任委员
魏火曜	人
1355年	年
赖忠坚	港人
玉带桥	廊桥
林建隆	评论员
刘震东	牺牲者
赵州	州
木村沙织	人物
胡慧冲	评论家
刘媛媛	人
王杰	人物
王照华	副部长
吴中行	人
龙宫城	建筑物
陈克寒	社长
刘芳远	委员
马家辉	人物
穆家峪镇	乡镇
韦秋香	柳州人
苏雨	人
佝偻病	疾病
莫仁	作家
宣仁皇后	皇后
潘木枝	人
干勇	冶金学家
高方	大理人
虺	人
陈捷贵	人
钱烈宪	作家
刘启文	牺牲者
李秀敏	人物
雷有邻	人物
新竹市	城市
何毓琦	人
柯震东	澎湖人
李明	科学家
林明达	人物
李保川	台湾人
新塍镇	乡镇
高惜冰	参政员
丘进	校长
那珂郡	郡
归淳州	州
林建岳	商人
李华	作家
王小凡	人
笋岗路	道路
登徒子	人物
1400年	年
邹石麟	人
贵屿镇	建制镇
陈仙辉	科学家
高鲁	人物
石苞	人物
郑宜农	同性恋者
秦梦瑶	演员
洛克公园	公园
邹玉梅	党员
孟楠	人
祁达才	企业家
周志开	人
翁牛特旗	旗
史泽咸	众议员
同安区	辖区
何家英	人
伯邑考	人物
陈镛	人物
信都郡	郡
284年	年
马慧琪	配音员
王度庐	委员
河濑直美	人物
唐景陵	陵
益川敏英	人物
颜万进	党员
白云梯	人
鲁真公	人
毕构	官员
郭可盈	演员
李元	副部长
杨宋镇	行政区划
顾崇廉	委员
庄荷	从业员
筑波大学	机构
吴建豪	音乐家
巴戈	主持人
陈方安生	官员
林深靖	评论员
烈士陵园	陵园
谢启昆	人
张闻天	理论家
吴昊鹏	球员
钦州市	行政区划
金善宝	院长
比景郡	行政区划
七七事变	事变
苏竟	官员
陈留县	行政区划
龙潜	委员
黄小祥	人
嵇康	诗人
张成泽	党员
韩先楚	人物
蒋丽萍	艺员
后藤象二郎	获得者
邱若龙	画家
李荣灿	副省长
晋朝	帝国
樊金龙	秘书长
赵志凌	武术家
李璧琦	人
傅尧俞	人物
王进士	党员
胡适	红学家
王仁元	人
淋球菌	菌
夏政峰	人
石鼓区	辖区
单田芳	演员
严燕生	演员
北站	车站
梅芳	获得者
上海市	行政区划
孙治强	人
俞国行	人
张青云	人
宁瀛	作家
王元雅	人物
李咸池	龙海人
亚健康	健康
刘元元	主持人
裘琏	剧作家
金彗星	演员
陈法蓉	演员
张少琴	副省长
宝光寺	佛寺
张我华	参议员
郭一平	人
刘卫辰	人物
宾臣	家
徐承恩	历史学家
张东荪	杭州人
宋小宝	人
平舌音	辅音
濮文暹	举人
拉苏荣	人
王丙召	人
闵智英	人物
八边形	多边形
向德宏	人物
周光召	物理学家
戚元靖	人
1529年	年
张哲瀚	演员
戴宝辉	人
朱学范	部长
韩苏	获得者
童雪儿	人
牛头人	生物
伊藤清	人物
李一氓	大使
许良英	活动家
姚平	人物
叶玮庭	学员
黄百韬	人
杨宏科	余姚人
张雪迎	人
竹沟镇	镇
潘芝莉	参赛者
赵九成	人
王鼎钧	华人
张涵予	获得者
黄正铭	宁海人
薛人仰	主任委员
孙广相	人
孙琳琳	运动员
李荣祥	人
刘德树	人
解放桥	桥梁
冀元亨	举人
潘德舆	学者
白文选	人
栗林公园	公园
楚门镇	行政区划
戴忠仁	主持人
工笔画	绘画
黄宏	委员
许飞	吉林人
宫崎勤	人
夏光	大使
小野镇幸	人物
黄念祖	人物
黄耀富	球员
对外经济贸易大学	大学
计六奇	无锡人
李津成	市长
张景淳	艺员
金永哲	演员
1249年	年
和平号	关系
金文鑫	守门员
李海涛	副省长
陆镇藩	人
黄若	钢琴家
刘友梅	企业家
焦利	台长
申东旭	人物
侯度	人
江小涓	委员
西燕	国家
张歆海	人
正脊	屋脊
江毅	逝世者
妮娜	角色
苏西智	议员
中岛裕翔	演员
程建人	人
刘锡贤	演员
宝显庭	人
殷仲堪	人物
亚依	舞蹈家
陈良玉	富顺人
1213年	年
袁象先	人
李东华	运动员
刘诗	人
李香兰	人
沈彭年	作曲家
塞内加尔	政权
黄石市	城市
陈健	举人
李祖沛	委员
陈国良	人
傅培梅	制作人
史林	演员
广信府	府
罗汝才	人物
潘辉注	学者
吴大江	指挥家
允常	人物
余饶理	人物
陈安羽	市长
苏民	演员
仵德厚	人物
王赓武	校长
兰姆酒	酒
唐季珊	企业家
韩可露	演员
二滩水电站	水电站
铃木启太	人物
炎黄艺术馆	美术馆
吴海鹰	党员
梁富华	议员
宁夏省	省份
尖山区	辖区
陈揆	书家
柏杨	人
关呈远	大使
衣谷游	人物
植廷晓	人物
胡永继	官员
李开芳	人
沈日新	宁波人
毛尖	家
李明宪	主持人
崔郾	人
卫绾	人
符强	委员
孙德昭	人物
黎智英	人
赵彦呐	人物
赖勋彪	制作人
515年	年
胡竞英	演员
黄耀明	人
马志翔	获奖者
李润华	球员
后龙镇	行政区划
李绍德	委员
黄威	球员
夏克立	加拿大人
陈逢源	诗人
梁治平	法学家
孙连仲	委员
支谦	家
李顺载	演员
平泽进	人物
袁希洛	宁波人
王英凡	委员
苍井优	演员
柳承完	人物
潘玮柏	人
李子芳	人
于淼	艺员
于培顺	人
帕斯加兰	地理
荒岛	岛
孟昭亮	副省长
钟皎光	部长
张法鹤	台湾人
郑锡元	人物
